软件开发云中各个区域的数据是否共通？	软件开发云中各个区域的数据不共通，各自独立，如：东北区创建的项目、代码仓库、任务等，在华北区看不到，反之一样。此外，各个区域中各服务的使用量、计费情况也是分开计算的。说明：软件开发云目前只支持东北区和华北区。
RDS实例在扩容期间是否一直可用	目前，RDS支持磁盘扩容和CPU内存规格变更。在磁盘扩容期间，RDS实例一直可用，业务不受影响，但不允许删除和重启实例。不支持磁盘扩容。在CPU内存规格变更期间，将会重启数据库服务，RDS实例不可用，用户无法连接实例。且在规格变更期间，该实例不可删除。
云服务器添加网卡后是否会自动启动？	弹性云服务器的操作系统为CentOS7时，添加网卡后在弹性云服务器内部无法自启动，需要手动激活。
什么是云硬盘	云硬盘，EVS是一种基于分布式架构的，可弹性扩展的虚拟块存储设备。您可以通过管理控制台创建云硬盘并挂载给云服务器，云服务器可以为弹性云服务器或者裸金属服务器，云硬盘的使用方式与传统服务器硬盘完全一致。同时，云硬盘具有更高的数据可靠性，更高的I吞吐能力和更加简单易用等特点，适用于文件系统、数据库或者其他需要块存储设备的系统软件或应用。云硬盘也称磁盘。
我可以共享我在OBS上的对象数据吗？	我可以共享我在OBS上的对象数据吗？显示对象URL我可以共享我在OBS上的对象数据吗？我可以共享我在OBS上的对象数据吗？对象URL对象共享功能，可实现匿名用户通过共享链接地址，直接访问对象数据。提供对象URL功能，当用户为特定对象设置了匿名用户的读取权限时，所有匿名用户均可使用该对象的URL链接地址，快速访问此特定对象。
如何确保在VPC中运行的DDS的安全	安全组可用来帮助确保VPC内实例的安全。此外，通过网络访问控制列表，可以允许或拒绝进入和退出各个子网的网络流量。内部安全基础设施包括网络防火墙、入侵检测和防护系统可以监视通过IPsecVPN连接进入或退出VPC的所有网络流量。
会议设备激活失败，无法接入会议？	激活失败，无法接入会议？会议设备注册失败。登录会议设备界面，观察右下角是否有图标。如果没有，则表示SIP注册失败。单击系统配置基本信息，查看系统时间是否与当前时间差距较大，将系统时间调整为当前时间。如上述方法仍未解决问题，请联系客服人员，检查SIP号码是否被加入黑名单。
RDSforMySQL支持哪些存储引擎	目前只支持InnoDB存储引擎。
是否支持第三方JDBC和ODBC驱动？	支持开源PostgreSQL的JDBC和ODBC驱动，也支持Redshift的JDBC和ODBC驱动，可能存在兼容性问题。
云监控服务是否收费？	云监控服务目前免费提供，无需付费。
弹性负载均衡是否需要手动申请IP？	弹性负载均衡的IP为在创建过程中自动分配的，不需要进行手动申请。
什么是桶？	什么是桶？显示一般性问题什么是桶？什么是桶？是OBS中存储对象的容器。对象存储提供了基于桶和对象的扁平化存储方式，桶中的所有对象都处于同一逻辑层级，去除了文件系统中的多层级树形目录结构。对象存储服务设置有三类存储类别，分别为：标准存储、低频访问存储、归档存储，从而满足客户业务对存储性能、成本的不同诉求。创建桶可以指定桶的存储类别。OBS中的每个对象与其所属桶的存储类别相同。详情请参见存储类别简介在OBS中，桶名必须是全局唯一的且不能修改，即用户创建的桶不能与自己已创建的其他桶名称相同，也不能与其他用户创建的桶名称相同。每个桶在创建时都会生成默认的桶ACL，桶ACL列表的每项包含了对被授权用户授予什么样的权限，如读权限、写权限、完全控制权限等。用户只有对桶有相应的权限，才可以对桶进行操作，如创建、删除、显示、设置桶ACL等。一个用户最多可创建100个桶，但每个桶中存放的对象的数量和大小总和没有限制，用户不需要考虑数据的可扩展性。
我申请的裸金属服务器是否在同一子网？	由于您可以自定义网络，所以裸金属服务器是否在一个子网，完全由您来控制。
哪些服务可以使用Anti	仅支持对公有云内的弹性云服务器和弹性负载均衡提供流量清洗功能。
屏幕共享了，与会者看不到屏幕	网络问题：查看共享者的带宽情况，共享端第一帧比较大。如果用户的网络很差，在8秒内无法传完这帧的数据，则会被抛弃并重新生成关键帧，如果持续不能上传，则会导致对方看不到。
什么是数据卷？	数据卷是指将宿主机节点的某个绝对路径挂载到容器的某个路径，与Docker命令的参数效果相同，通过挂载可以实现宿主机和容器之间的共享。下面的Docker命令启动一个名称为frontend的容器，将宿主机的目录挂载到容器的目录中。在CCE中，您可以在使用图形化编排工具的时候设置挂载点，将宿主机的目录挂载到容器中。
如何创建和连接ECS	创建ECS，请参见弹性云服务器用户指南中的购买弹性云服务器该ECS用于连接RDS实例，需要与准备使用的RDS实例处于同一VPC内。正确配置安全组，使得ECS可以通过连接地址访问RDS实例。连接ECS，请参见弹性云服务器用户指南登录弹性云服务器的内容。
什么是调度策略？	根据应用的部署特性，平台把应用拆解成最小的部署实例，应用调度器实时监控应用的实例信息，当发现有新的pod产生需要调度的时候就会对集群中所有的剩余资源计算、存储、网络进行计算，最后得出最适合的调度目标节点。平台支持多种调度算法，包括：应用和节点之间的亲和性调度、应用间的亲和反亲和调度。
弹性负载均衡分配的公网IP是否为独占？	在您购买使用ELB服务的整个生命周期内，该服务地址都是由您所购买的服务独占的。
已删除的裸金属服务器是什么意思？	这是一种裸金属服务器的中间状态。说明服务器已被正常删除，在该状态下的裸金属服务器，不能对外提供业务，将会在短时间内从系统中彻底清除。
我可以通过哪些管理工具使用OBS？	我可以通过哪些管理工具使用OBS？显示一般性问题我可以通过哪些管理工具使用OBS？我可以通过哪些管理工具使用OBS？管理控制台对象存储服务在Portal中与云服务的其它服务产品共同提供Web版的用户统一自服务控制台，用户在统一自服务控制台内可以完成云服务中包括云存储在内各项产品的自服务操作。客户端您可以安装OBS管理客户端软件，通过客户端软件管理OBS中存储的资源。OBS客户端软件包集成在OBS管理控制台中，登录OBS管理控制台，在OBS管理控制台主界面单击下载OBS客户端您可以通过调用简单的RESTAPI接口来访问管理数据。
什么是镜像？	镜像是一个模板。例如，一个Docker镜像可以包含一个完整的ubuntu操作系统环境，里面仅安装了用户需要的应用程序及其依赖文件。Docker镜像用于创建Docker容器。Docker本身提供了一个简单的机制来创建新的镜像或者更新已有镜像，您也可以下载其他人已经创建好的镜像来使用。镜像分为示例镜像、我的镜像和Docker官方镜像。示例镜像为CCE服务内置示例镜像，任何用户均可使用。我的镜像为CCE镜像仓库中的镜像，为私有镜像。私有镜像是由用户上传的仅供个人使用的个人镜像。官方镜像为第三方公共仓库中的镜像。CCE支持从第三方公共仓库中下载使用镜像。
通信平台云提供哪些能力？	语音能力提供网络直拨及会议的语音通话能力，抗丢包能力强，语音效果好。视频能力提供点对点视频通话和视频会议能力，实现类面对面的沟通，视频分辨率支持从低分辨率视频到高清视频可调节。由于受到互联网网络的影响，用户侧网络的复杂情况，存在视频无法建立或视频不清晰情况。协作能力提供文档共享格式、电子白板标注和查看、屏幕共享共享屏幕和远程控制等能力，实现实时互动交流。开发包提供Windows平台SDK，并提供丰富的代码样例、开发Demo等，最少仅仅开发几行代码就可以快速体验云端高质服务。
DES服务如何确保上传的数据和我的服务单相匹配不会出错？	用户提交数据快递服务申请后，系统会生成磁盘签名文件，磁盘签名文件是服务单中磁盘的唯一标识，需要将其存放入磁盘根目录且不对其加密，然后将磁盘寄送到华为数据中心。华为数据中心管理员收到磁盘后直接将磁盘挂载到物理服务器上，系统会自动判断用户申请单中的信息与磁盘信息是否准确对应，磁盘信息匹配成功后，用户需填写AK和加密密钥触发数据开始自动上传，数据上传过程中均无任何人工干预，以此来避免人为误操作。
如何调用短信业务API？	操作步骤使用已注册的帐号登录华为云网站：选择产品云通信消息短信，申请公测后，开通消息短信服务。在消息短信服务管理控制台，单击登录开发者Portal，根据帮助中心提供的接口文档完成相应的应用开发，调用短信业务API。
MRS有哪些特点和优势？	的主要特点和优势在于：易用提供Hadoop、Spark、SparkSQL、HBase和Hive能力，全流程统一的SQL交互接口使得大数据开发变得更加简单。低成本免运维，计算和存储分离，计算的集群可以按需创建，作业运行结束就可以释放集群。稳定您用于调试和监视集群的时间将更少，服务可用性高，数据可靠性高开放积极拥抱开源大数据生态，兼容开源，易于与其他服务对接，提供RESTAPI、JDBC等多种使用方式。
软件开发云中免费额度的使用期限有多久？	软件开发云中的免费额度没有使用期限，只要使用量没有超出额度，就可以一直免费使用。
专属云如何计费？	专属云服务不同于其他服务，需要开通后才能使用。已经开通专属云服务的用户，可以通过包年的方式购买设备节点资源。专属云内支持按需购买云服务器，计算资源不计费，使用用户已申请的设备节点剩余的计算资源。云服务器内云硬盘及弹性IP按需计费。按需购买云服务器时，云硬盘及弹性IP等的按需费用会比包周期的费用偏高，如果您长期使用云服务器，建议您先在云硬盘及VPC处包周期购买云硬盘及弹性IP，再根据需要将云硬盘及弹性IP绑定在按需创建的云服务器上。
每个用户可以创建多少个主题？	公测期间，每个用户可以最多创建3000个主题。每个用户可以最多创建3000个主题。
如何修改Linux弹性云服务器网卡的MTU值?	最大传输单元是指一种通信协议的某一层上所能通过的最大数据报大小，取值范围1280，以字节为单位。以密集存储型弹性云服务器为例，针对SUSE、CentOS和Ubuntu操作系统，介绍Linux弹性云服务器网卡的MTU值的修改方法。操作系统以操作系统SUSEEnterpriseLinuxServer11SP364bit为例，具体操作如下：使用管理员帐号登录弹性云服务器，执行命令切换至root用户。执行命令，查看IP地址绑定的网卡。执行以下命令，打开文件说明：表示中查询到的IP地址绑定的网卡，如eth0。
误删了的数据能否找回？	误删了的数据能否找回？显示安全性误删了的数据能否找回？误删了的数据能否找回？建议启用版本控制功能，不带版本号删除对象仅产生一个带唯一版本号的删除标记，并不删除对象，从而可以找回数据。如果未启用版本控制功能，或启用该功能后指定版本号删除了对象，OBS将彻底删除这些数据，将无法找回。
什么是环境变量？	环境变量是指容器运行环境中设定的一个变量，您可以在创建容器模板时设定不超过30个的环境变量；环境变量可以在应用部署后修改，为应用提供极大的灵活性。
PC客户端接入会议时连接服务器失败？	会议时连接服务器失败？通过邮件链接单击加入会议进行入会时，选择使用本地耳麦和摄像头可以入会，但选择使用本地客户端时无法入会。需要修改会控参数，在PC客户端安装路径下如安装在C盘，则路径为找到config，用记事本打开，将会控参数中的修改为即可。
使用云服务器备份服务恢复数据时，需要停止云服务器吗？	恢复数据时系统会关闭云服务器，待数据恢复后系统会自动启动云服务器。如果取消勾选恢复后立即启动云服务器，则需要用户手动启动云服务器。
一般性问题	显示一般性问题一般性问题
文件系统数据持久度如何？	文件系统设计可达99个9的数据持久度，通过对象存储方式保障数据安全、完整。
如何使用CloudIDE？	是面向软件开发者的云端开发环境，支持在云端创建工作空间，在线编写代码、智能提示、代码调试、代码检视、代码提交、配合代码检查修改代码缺陷、代码片段示例代码搜索等功能。
没有我要的操作系统镜像，怎么办？	如果没有你所需要的镜像文件，可拨打免费客服电话4000咨询或者邮件至hwclouds邮箱。
如何选择地域？	地域是一个地理区域的概念。我国地域面积广大，由于带宽的原因，不可能只建设一个数据中心为全国客户提供服务。因此，我们根据地理区域的不同将全国划分成不同的地域。选择地域时通常根据就近原则进行选择，例如您或者您的客户在北京，那么您可以选择华北服务区，这样可以减少访问服务的网络时延，提高访问速度。
如何使用发布管理？	发布管理是面向软件开发者提供软件发布管理的云服务，提供软件仓库、软件发布、发布包下载、上传、发布包元数据管理等功能，通过安全可靠的软件仓库，实现软件包版本管理，提升发布质量和效率，实现产品的持续发布。
支持何种代码开发的作业？	只支持使用SQL语句开发作业。
软件开发云中项目用户如何管理企业成员？	前提条件已经注册华为云用户即企业管理员
集群支持提交哪些形式的Spark作业？	当前在MRS页面，集群支持提交Spark、SparkScript和SparkSQL形式的Spark作业。
DES最多支持传输多少数据？	使用DES传输的数据最终存储在对象存储服务中。OBS服务的容量可无限扩展，用户只需尽情享用云存储带来的无限空间，无需担心传输过多的数据而无处存放。
用户平时需要关注实例的哪些性能指标	用户需要关注的监控指标有：CPU利用率、内存利用率、磁盘空间利用率。可以根据实际应用场景配置告警提示，当收到告警，可采取相应措施消除告警。配置示例如果在某段时间内如5min，CPU的利用率出现多次如3次不低于某特定值如90的情况，则发出相应CES告警。如果在某段时间内如5min，内存的利用率出现多次如4次不低于某特定值如90的情况，则发出相应CES告警。如果在某段时间内如5min，磁盘的使用率出现多次如5次不低于某特定值如85的情况，则发出相应CES告警。说明：告警详细配置方法，详见云监控服务用户指南告警规则管理
DES如何保证我的数据不会被盗用？	支持用户使用第三方工具Truecrypt对数据进行加密后再传输，确保邮寄途中的数据安全。数据上传需要由您手工数据AK和加密密钥自动触发，全程无人接触密钥和数据。通过DES传输的数据最终保存在对象存储服务OBS中，OBS服务将数据分片随机存储在不同硬盘上，即使整块硬盘被盗走也无法恢复成完整数据。
已删除的弹性云服务器可以再开通吗？	已删除的弹性云服务器在管理控制台的弹性云服务器列表中只会停留较短时间，系统稍后便会将其彻底清除，因此不可以用来恢复系统和数据。您可以再次购买同样规格的弹性云服务器。
哪些云服务使用KMS加密数据？	对象存储服务和镜像服务借助KMS服务实现了加密特性。
没有对云服务器进行相关预置操作会带来什么影响？	如果您没有将云服务器网卡配置成DHCP，或者没有删除残留的udev规则。那么，通过镜像文件注册的私有镜像所创建出的云服务器仍和源镜像文件中的配置保持一致，或者出现云服务器的网卡不从eth0开始的情况。此时，您需要通过云服务器的远程登录功能对云服务器再次进行手动配置。如果用于创建您的Linux云服务器的镜像没有提前进行手动配置，在创建Linux云服务器过程中可能会导致以下三种情况出现。无法实现自定义密码注入。无法注入证书。无法实现其他可能的云服务器自定义配置。如果您没有清理文件中对用户磁盘的自动挂载检测相关信息，可能会导致创建出来的云服务器在启动时出现异常。
如何给弹性云服务器挂载新的磁盘？	请登录管理控制台，选择云硬盘，申请云硬盘并绑定给云服务器。
攻击事件能否及时通知？	可以。告警通知设置界面开启告警通知后，在受到DDoS攻击时用户会收到报警信息短信或邮件提醒
可以在OBS上托管我的静态网站吗？	可以在OBS上托管我的静态网站吗？显示静态网站托管可以在OBS上托管我的静态网站吗？可以在OBS上托管我的静态网站吗？存储类别为标准和低频访问的桶支持静态网站托管。用户可以通过OBS管理控制台将自己的桶配置成静态网站托管模式，当客户端通过桶的website接入点访问桶内的对象资源时，浏览器可以直接解析出这些网页资源，呈现给最终用户。
无法访问机器学习服务实例时怎么处理？	检查原因请检查MLS实例状态是否正常。如果是在互联网环境无法连接，还需要检查以下可能导致异常的原因：用户网络是否与互联网可以正常连通。用户网络防火墙策略是否限制了访问。用户网络是否需要通过代理才能访问互联网。请联系网络管理员解决。
弹性文件服务支持哪些访问协议？	弹性文件服务支持标准的NFSv3协议，实现文件共享功能。
什么是云目录服务？	云目录服务是一个对可在华为云上进行部署的IT服务进行集中管理、分配和使用的服务。云目录服务的用户分为管理员和最终用户。利用云目录服务，管理员可以集中管理和部署IT服务，并将资源合理、有效、高效地分配给需要的最终用户。同时让最终用户能够快速查找和启用其需要的、已获批准的IT服务，简化部署和整合IT服务的成本。云目录服务的基本组成部分有：产品、产品组合、版本、授权、约束、产品实例、配额管理。云目录服务的架构如图1所示。图1云目录服务架构点击放大
磁盘签名文件有什么作用？	磁盘签名文件是服务单中磁盘的唯一标识，需要将其存放入磁盘根目录且不对其加密，然后将磁盘寄送到华为数据中心。华为数据中心管理员收到磁盘后直接将磁盘挂载到物理服务器上，系统会根据磁盘签名文件自动匹配磁盘与服务单，避免人工干预带来的误操作。
用户短信直发的限制是什么？	短信直发时，同一个手机号码限制一小时内最多发送10条短信，一天最多发20条短信。向主题发布消息时则没有限制。
如何使用测试管理？	测试管理是面向软件开发者提供的一体化测试管理云服务，覆盖测试需求、用例管理、测试任务管理、缺陷管理，多维度评估产品质量，帮助用户高效管理测试活动，保障产品高质量交付。
如何使用机器学习服务？	机器学习服务的基本使用流程如图1所示：图1基本使用流程点击放大
OBS可以用于哪些场景？	可以用于哪些场景？显示一般性问题可以用于哪些场景？可以用于哪些场景？主要面向以下几类应用场景提供存储服务：存储类别适用场景场景描述标准存储大数据分析大数据应用例如基因、财务、气象、广告等直接通过Internet将文件、图片、视频直接存入OBS。原生云应用程序数据提供高性能、高可用性存储服务，移动和互联网应用程序从而能够使用高扩展和低成本和高效的存储服务。利用OBS使用任意量的数据，并在任何位置访问内容。低频访问存储静态网站托管网站经营者或个人网站发布者，将OBS作为静态网站托管资源池，在将静态网页上传到OBS后，通过设置网站功能，托管整个静态网站，并且通过CDN进行数据快速分发。备份活跃归档提供了高持久性、高扩展性以及安全的解决方案来备份和归档用户的关键数据。用户可以使用OBS的版本控制功能为存储的数据提供进一步的保护。高持久性、安全的基础设施旨在提供高级数据保护的稳固灾难恢复解决方案，支持第三方备份和归档软件，如：CommVault、NBU等。其他服务场景如镜像服务IMS、云硬盘备份VBS、RDS数据库等服务，使用OBS作为各自服务的存储资源池或备份存储等。归档存储深度冷归档用户的数据需要长期备份，如存储几个月，乃至几年，并对延时不敏感的数据，如果用户提取数据时能够容忍小于12小时的时间延迟就可以考虑使用归档存储产品。
Anti	提供针对以下攻击的防护：攻击、CC攻击、慢速连接类攻击、UDP攻击、ACKFlood攻击、TCP类攻击等DDoS攻击。
一个应用软件是否可以将应用软件中不同的部件分散部署到不同的地域？	可以，但是不建议这种部署方式。建议将一个应用软件内的不同部件部署到同一个地域，这样不同部件之间的通信可以采用内网网络通信，既可以节省因采用公网网络通信带来的带宽费用，又可以保证不同部件之间的网络通信质量。
消息的长度限制是多少?	每条消息的大小不超过512KB包括消息体和消息属性
如何保证节点缓存数据的更新和同步？	节点的缓存内容不是实时更新的，只有当缓存内容到期后才能回源拉取最新的内容。您可以通过设置缓存过期时间规则或者提交刷新请求来实现缓存内容的更新。
什么是弹性伸缩？	弹性伸缩服务是根据用户的业务需求，通过策略自动调整其业务资源的服务，简称弹性伸缩或AS。您可以根据业务需求自行定义伸缩配置和伸缩策略，降低人为反复调整资源以应对业务变化和高峰压力的工作量，帮助您节约资源和人力成本。典型的弹性伸缩活动如图1所示。图1弹性伸缩图例点击放大
项目管理各角色类型对应的操作权限是什么？	针对项目下资源，项目管理中用户的角色类型及对应的操作权限说明，如表1所示。表1角色类型及操作权限角色操作迭代工作项文档管理百科管理项目设置基本信息通知模块领域成员项目创建者全部权限：创建、删除迭代；修改、查看迭代详情管理项目下的所有工作项：创建、修改、删除、查看工作项以及自定义工作项的模板评论、搜索、过滤工作项添加、修改标签导入、导出工作项创建子工作项删除Epic管理项目下的所有文档，包括创建、修改、删除、查看目录上传、下载、删除文件管理项目下的所有词条，包括：创建、查看、编辑、删除、搜索、筛选词条移动词条分类设置栏目编辑布局管理项目下的所有成员，包括添加、删除、修改项目成员、修改成员角色。删除项目修改项目基本信息设置消息通知配置项目的模块配置项目的领域项目经理全部权限：创建、删除迭代；修改、查看迭代详情管理项目下的所有工作项：创建、修改、删除、查看工作项以及自定义工作项的模板评论、搜索、过滤工作项添加、修改标签导入、导出工作项创建子工作项删除Epic管理项目下的所有文档，包括创建、修改、删除、查看目录上传、下载、删除文件管理项目下的所有词条，包括：创建、查看、编辑、删除、搜索、筛选词条移动词条分类设置栏目编辑布局管理项目下的所有成员，包括添加、删除、修改项目成员。修改非项目经理成员角色。修改项目基本信息设置消息通知配置项目的模块配置项目的领域测试经理全部权限：创建、删除迭代；修改、查看迭代详情管理项目下的所有工作项：创建、修改、删除、查看工作项以及自定义工作项的模板评论、搜索、过滤工作项添加、修改标签导入、导出工作项创建子工作项删除Epic查看项目下的所有文档。增加、删除、修改自己上传的文档。查看、编辑项目下的所有词条，可增加、删除、修改自己发布的词条。管理项目下的测试人员和浏览者，包括添加、修改和删除。修改项目基本信息设置消息通知配置项目的模块配置项目的领域开发人员创建、查看工作项修改自己的工作项评论、搜索、过滤工作项添加、修改标签导入、导出工作项创建子工作项修改自己创建的Epic详情查看项目下的所有文档。创建、修改、删除、查看自己的目录上传、下载、删除、移动自己的文件修改自己的文件详情查看、编辑项目下的所有词条，可增加、删除、修改自己发布的词条。查看项目成员测试人员创建、查看工作项修改自己的工作项评论、搜索、过滤工作项添加、修改标签导入、导出工作项创建子工作项修改自己创建的Epic详情查看项目下的所有文档。创建、修改、删除、查看自己的目录上传、下载、删除、移动自己的文件修改自己的文件详情查看、编辑项目下的所有词条，可增加、删除、修改自己发布的词条。查看项目成员浏览者创建、查看工作项修改自己的工作项评论、搜索、过滤工作项添加、修改标签导入、导出工作项创建子工作项修改自己创建的Epic详情查看项目下的所有文档。创建、修改、删除、查看自己的目录上传、下载、删除、移动自己的文件修改自己的文件详情查看、编辑项目下的所有词条，可增加、删除、修改自己发布的词条。查看项目成员
华为云帮助中心	特殊类型的弹性云服务器仅支持特定的操作系统类型，如果镜像的操作系统不匹配，则由该镜像创建的弹性云服务器将无法正常使用，详情请参考弹性云服务器用户指南特殊弹性云服务类型与操作系统版本的关系如表1所示。未列举出来的弹性云服务器类型支持的操作系统与公共镜像列表保持一致。表1特殊弹性云服务器类型与支持的操作系统版本弹性云服务器类型支持的操作系统版本优化型优化型密集存储型高计算型
我可以使用多版本控制做什么？	我可以使用多版本控制做什么？显示多版本控制我可以使用多版本控制做什么？我可以使用多版本控制做什么？开启多版本控制后：上传对象时，OBS自动为每个对象创建唯一的版本号。上传同名的对象将以不同的版本号同时保存在OBS中。可以指定版本号下载对象，不指定版本号默认下载最新的对象。如果需要彻底删除对象，必须在对象列表显示版本的情况下指定版本号进行删除，且删除后不可恢复。如果在对象列表隐藏版本的情况下，则删除对象后，OBS将仅产生一个带唯一版本号的删除标记，而并不实际删除该对象，当有访问该对象的请求时，则提示对象不存在；如果将删除标记删除，可取消对对象的删除。列出桶内对象列表时默认列出最新对象列表，也可以指定列出桶内所有版本对象列表。除删除标记外，每个版本的对象存储在OBS中均需要进行计费。当不需要对桶内对象进行版本控制时，可以暂停多版本控制：旧的版本数据将继续保留在OBS中，您需要手动删除不再需要的旧版本数据。仍可以指定版本号下载对象，不指定版本号默认下载最新的对象。除删除标记外，旧版本的对象存储在OBS中仍需要进行计费。
影响迁移效率的主要因素	专线网络带宽及网络质量。迁移源主机和目的虚拟机的磁盘IO。迁移数据总量大小。源主机和目的主机性能如：CPU、内存等
服务单状态是“待上传AK/SK”是什么意思？	待上传AK是什么意思？当数据中心接收到您邮寄的磁盘，且管理员将磁盘挂载成功后，服务单状态将变为待上传AK。此时需要您登录DESConsole填写AK和加密密钥启动数据上传。
按需付费的弹性云服务器关机后还会计费吗？	不同类型的弹性云服务器，关机后的计费规则不同。具体如下：普通云服务器除密集存储型弹性云服务器之外的其他类型云服务器，我们称之为普通云服务器。对于此类按需付费的弹性云服务器，关机后，基础资源包括vCPU、内存、镜像不计费，但系统盘仍会收取容量对应的费用。如有其他绑定的产品，如云硬盘、弹性IP、带宽等，按各自产品的计费方法包年包月按需付费进行收费，具体请参见产品价格详情密集存储型弹性云服务器对于此类按需付费的弹性云服务器，关机后仍然计费。如果停止计费，需删除弹性云服务器。
什么是软件开发云？	软件开发云华为软件开发云是面向开发者提供的云服务，即开即用，随时随地在云端进行项目管理、配置管理、代码检查、流水线、编译、构建、部署、测试、发布等，让开发者快速而又轻松地开启云端开发之旅。
如何获得OBS服务？	如何获得OBS服务？显示一般性问题如何获得OBS服务？如何获得OBS服务？在云服务网申请成云服务正式用户，在网站申请开通OBS，开通后，使用生成密钥即可直接使用OBS。
关于弹性云服务器上使用第三方软件技术支持的说明	尊敬的华为云客户，您好！为使您在使用弹性云服务器产品时无后顾之忧，华为云为您提供了部分第三方软件的技术支持，不断提升产品相关的服务能力。具体包括如下第三方软件在弹性云服务器上安装、配置和问题排查的建议。服务数据库服务网络安全服务的Iptables的Firewall其他网络服务、Windows远程和路由访问、FTP华为云服务团队向您提供的第三方软件的建议只针对有经验的系统管理员或其他相关IT人员，华为云服务团队不负责上述第三方软件的安装、调试及建议的具体实施。对于上述服务出现的问题我方也并非全部负责解决。为方便您理解，详细说明如下：我们可以协助您排查或提供建议：服务：端口不通、访问报4XX的问题。数据库：远程连接失败、改造监听端口。防火墙：在iptables和Firewall上添加规则、开放端口。网络服务：ssh连接不上、Windows远程连接不上。：无法代理上网的问题。：LinuxDNS的基本配置。需要您自行设置、排查与优化：服务：优化配置、编写伪静态规则、插件调试等。数据库：数据库调优、SQL语句优化等。防火墙：基于iptables构建自动化检测防御工具等。网络服务：SSH传输文件速度优化、SFTP如何限速等。：多个OpenVPN互联等。：LinuxDNS组网规划及配置优化。
服务端问题导致连接失败	服务端可能出现的问题如下，请依次进行检测。连接数满导致连接失败。解决方法：通过CES的资源监控功能查看连接数、CPU使用率等指标是否正常，如果达到上限，需要重启、断开实例连接或扩容节点解决。实例状态异常，比如实例重启卡住，系统故障等。解决方法：尝试重启功能。如果无法解决，请联系售后技术支持。
外表支持的数据格式有什么区别？	外表支持CSV格式文件，或者文本类型的其他格式文件，二者主要不同如下：由记录组成，每条记录被分隔符分隔为字段，且每条记录都有同样的字段序列。可以有效处理数据列中的换行符，但对一些特殊字符处理有欠缺。可以有效处理一些特殊字符，但无法正确处理数据列中的换行符。
为什么消费消息后需要确认？	为了保证消息的可靠性。消息发送和消费过程中的可靠性必须由DMS服务、生产者和消费者协同工作才能保证，只有当消费者确认该消息消费成功后，DMS才认为消息消费成功。在消费者消费消息M期间，消息M仍然停留在队列中，但消息M从被消费开始的30秒内不能被该消费组再次消费，若在这30秒内没有被消费者确认消费完成，则DMS认为消息M未消费成功，将可以被继续消费。说明：只有使用API的时候才需要确认消息，使用Console控制台的时候不需要。
如何预测攻击者下一步攻击手段？	可通过安全态势感知里的攻击者态势分析来预测：攻击者态势界面，单击攻击者ID。查看该攻击者的攻击技能图谱，查看攻击者的惯用攻击手段。通过统计攻击者曾经使用过的攻击手段如DoS攻击、Web攻击、OS漏洞利用、应用漏洞利用、暴力破解，分析对比其在云平台中使用的次数和针对本用户的次数，帮助用户了解攻击者偏好和擅长领域，预测其下一步可能使用的手段和方法。例如图1所示，用户根据技能图谱则可预测：该攻击者接下来很可能使用拒绝服务攻击。图1攻击者技能图谱点击放大
数据仓库使用哪些安全防护？	数据仓库服务使用IAM和VPC来控制用户、集群的网络安全隔离。用户对集群的访问则采用了SSL安全连接和安全算法套件，支持双向数字证书认证。同时在每个集群中对节点的操作系统进行安全加固，仅允许合法地访问操作系统文件，提高数据安全性。
ECS无法连接到RDS实例的原因	遇到该问题，参考以下步骤排查解决。先确认ECS实例和RDS实例是否在同一个VPC。如果在，执行如果不在，需要重新创建ECS实例，使之和RDS实例在同一个VPC下。查看ECS实例是否添加安全组。如果有，检查安全组的配置规则是否满足要求，请参见购买RDSMySQL实例的表格中安全组的描述，然后执行如果没有，从ECS的实例详情页面，进入VPC页面，选择安全组，添加安全组。在弹性云服务器ECS上，测试是否可以正常连接到RDS实例地址的端口。的默认端口为8635。的默认端口为8635。的默认端口为8433。连接地址端口号如果可以通信，说明网络是正常的。如果端口不通，请联系售后技术支持协助排查。
如何获得华为DES服务？	在华为云网站申请成为华为云正式用户，申请成功后即可进入管理控制台开通使用DES。
可以通过创建模板的方式创建实例吗	在创建实例时，不需要使用模板。用户可选择不同实例规格，相当于提前准备好了很多模板，提供给用户创建实例。
是否支持泛解析？	支持。您可以通过使用通配符作为主机名来创建泛解析记录。更多详情，请参见RFC4592。当前公有云平台支持的泛解析记录类型为A、AAAA、MX、CNAME、TXT五种类型的记录集。
用户平时需要关注实例的哪些监控指标	用户需要关注的监控指标有：CPU利用率、内存利用率、磁盘空间利用率。可以根据实际应用场景配置告警提示，当收到告警，可采取相应措施消除告警。配置示例如果在某段时间内如5min，CPU的利用率出现多次如3次不低于某特定值如90的情况，则发出相应CES告警。如果在某段时间内如5min，内存的利用率出现多次如4次不低于某特定值如90的情况，则发出相应CES告警。如果在某段时间内如5min，磁盘的使用率出现多次如5次不低于某特定值如85的情况，则发出相应CES告警。说明：告警详细配置方法，请参见云监控服务用户指南告警规则管理
如何收藏导航栏菜单？	若经常使用某个功能，可参照本章节收藏该功能的菜单。本章节以收藏应用资源管理为例进行说明。说明：系统最多可以显示最近的29个收藏。
我可以在OBS上获取到桶操作的日志记录吗？	我可以在OBS上获取到桶操作的日志记录吗？显示访问日志记录我可以在OBS上获取到桶操作的日志记录吗？我可以在OBS上获取到桶操作的日志记录吗？可以。支持对桶的访问请求创建并保存访问日志记录，可用于进行请求分析或日志审计。由于日志存储在OBS中也会占用用户租用的OBS存储空间，也即意味着将产生额外的存储费用，默认情况下，OBS不会为用户的桶收集访问日志。出于分析或审计等目的，用户也可以开启日志管理功能。通过访问日志记录，桶的所有者可以深入分析访问该桶的用户请求性质、类型或趋势。当用户开启一个桶的日志管理功能后，OBS会自动将对这个桶的访问请求记录日志，并生成日志文件写入用户指定的桶即目标桶中。日志文件采用如下的命名方式存储到目标桶中：
拒绝后的共享镜像如何使用？	用户B拒绝了用户A的共享镜像的情况下，如果需要使用该共享镜像，需要告知用户A按照以下步骤完成操作。用户A在共享镜像租户列表中，删除用户B的帐户名称。请参考删除镜像的共享租户用户A重新将用户B添加为镜像的共享租户。请参考添加镜像的共享租户
软件开发云如何保证客户代码和应用安全？	华为公有云有IAM统一认证。软件开发云上每个项目均设有权限管理机制，项目管理员可以管理项目成员。软件开发云为企业级用户使用专属、隔离的环境，提供企业级病毒防护。存储和运行环境均有冗余节点，并提供跨区域容灾备份解决方案。
注册的镜像操作系统是CentOS类型，使用该镜像创建的云服务器找不到磁盘该如何处理？	通常情况下，这是由于没有启动时没有加载xen模块导致的，您需要修改操作系统内核启动参数。登录VNC后如图1所示。图1登录后界面点击放大
如何保证消息队列中的消息是安全的？	分布式消息服务提供了安全可靠的身份验证机制，确保消息队列受到保护，防止遭到未经授权的访问。
如何判断攻击者下一步目标？	的攻击者，通常不是一步达成攻击目的，而是步步为营、层层渗透，安全态势感知服务通过对攻击者的攻击或入侵进行分析，利用大数据挖掘及机器学习，匹配相应的攻击或入侵模型，可帮助用户判断攻击者下一步将要实施的动作。例如通过用户安全态势界面里的威胁分析，查看网络拓扑图，如图1所示。网络拓扑图列出用户所有ECS，根据所属子网、VPC、弹性IP进行组织，并直观呈现各设备间的关系。如果是针对性的APT攻击，用户可根据已被攻击的设备预测攻击者下一步的目标。图1网络拓扑图点击放大
如何访问OBS？	如何访问OBS？显示一般性问题如何访问OBS？如何访问OBS？通过OBS管理控制台直接管理数据。通过应用程序调用简单的RESTAPI接口来访问管理数据。通过RESTAPI调用时，每个桶都有自动分配的域名供访问。通过OBS客户端或者第三方的客户端管理数据。
哪些用户有权限使用加密特性？	对于一个用户组的用户，加密特性使用权限的规则如下：拥有SecurityAdministrator权限的用户可以直接授权EVS访问KMS，使用加密特性。普通用户即没有SecurityAdministrator权限的用户使用加密特性时，根据该普通用户是否为用户组内第一个使用加密特性的用户，作如下区分：是，即该普通用户是用户组内第一个使用加密特性的，需先联系拥有SecurityAdministrator权限的用户增加权限，然后再使用加密特性。否，即用户组内的其他用户已经使用过加密特性，该普通用户有权限直接使用加密特性。下面，我们以一个用户组为例，介绍授权EVS访问KMS时的用户权限问题。假设该用户组有4个用户用户1用户4，其中，用户1拥有权限，其他三个用户为普通用户，没有权限，如图1所示。图1用户组
什么是云报表服务？	云报表服务，简称CRS是一种快速便捷、在线式的数据可视化分析服务。用户可通过云报表服务对原始数据进行实时在线分析，生成丰富多样的可视化报表，从数据中快速获取业务发展趋势。
如何访问机器学习服务实例工作界面？	操作场景通过内网地址访问MLS实例用户所创建的MLS实例未绑定弹性IP，则需通过内网地址访问。内网访问地址只允许与MLS实例同一子网的客户端机器访问，需登录与MLS实例内网地址互通的弹性云服务器，以访问MLS实例。实例的运行状态为服务中通过公网地址访问MLS实例用户所创建的MLS实例已自动绑定弹性IP，可通过公网地址访问。实例的运行状态为服务中
MRS支持什么类型的分布式存储？	提供目前主流的Hadoop，目前支持Hadoop版本，并且随社区更新版本。
RDS支持的最大IOPS是多少	支持的IOPS取决于云硬盘EVS的IO性能，具体请参见云硬盘常见问题云硬盘的性能如何？的内容。
什么是DDS实例可用性	实例可用性的计算公式：实例可用性故障时间服务总时间
是否支持批量创建数据仓库？	用户在管理控制台只支持创建单个集群。
客户端问题导致连接失败	客户端问题导致连接RDS失败，可以从以下几个方面检查。弹性云服务器ECS的安全策略对于Windows平台，可检查Windows的安全策略是否开放RDS端口。对于Linux平台，可使用iptables检查防火墙及端口的放行情况。应用配置错误常见的有连接地址写错、端口参数配置错误和JDBC等的连接参数配置错误。用户名或密码错误如果连接数据库时出现类似如下错误，请检查用户名或密码是否正确。说明：如问题仍未解决，请联系售后技术支持。
如何访问DES？	您可以通过Internet访问华为云页面并登录，进入数据快递服务管理控制台。
客户端问题导致连接DDS失败	客户端问题导致连接失败，可以从以下几个方面检查。弹性云服务器ECS的安全策略对于Windows平台，可检查Windows的安全策略是否开放端口。对于Linux平台，可使用iptables检查防火墙及端口的放行情况。应用配置错误常见的有IP写错、端口参数配置错误和JDBC等的连接参数配置错误。说明：如问题仍未解决，请联系售后技术支持。
一个租户下可以开通多个追踪器吗？	目前，一个租户系统仅支持开通一个追踪器。
OBS如何收费？	如何收费？显示一般性问题如何收费？如何收费？对象存储服务提供按需、包年包月两种计费方式。详细的服务资费费率标准请参见购买指南对象存储服务默认是按需计费的，即按实际使用的时长收费，以小时为单位，按每小时整点结算，不设最低消费标准。具体结算时，共分为三个计费项，总费用为三者之和，如表1所示。表1按需计费资费项计费项描述存储空间计费数据存储分阶梯收费，使用容量越大，平均每GB的收费越便宜计费因子：存储容量、使用时长计费公式：费用每小时每GB费率存储容量使用小时数流量费用外网流入流量数据上传到OBS免费内网流出流量通过ECS云服务器下载OBS的数据免费外网流出流量计费因子：流量计费公式：费用每GB带宽费率每小时流出带宽请求费用请求类型上传、查询、下载、修改计费因子：请求数计费公式：费用请求数费率每小时请求数请求类型删除免费
服务单状态是“已取消”是什么意思？	已取消是什么意思？当DES服务单创建后，在服务单状态为待寄送磁盘时可以取消服务单，此时服务单状态将变为已取消
弹性云服务器的收费标准？	我们有按需、包年包月两种计费方式，您可以根据您的实际情况选择不同的计费方式。
什么是多版本控制？	什么是多版本控制？显示多版本控制什么是多版本控制？什么是多版本控制？多版本控制为用户意外覆盖或删除对象场景提供了一种恢复手段。默认情况下，OBS中新创建的桶不会开启多版本功能，向同一个桶上传同名的对象时，新上传的对象将覆盖原有的对象。
通过RDP远程连接的Windows弹性云服务器如何播放音频？	操作场景弹性云服务器默认禁用音频设备，导致无法通过远程桌面的方式使用音频设备。对于使用弹性云服务器作为云桌面的用户，如果需要播放音频、使用多媒体音频功能，可参见本节内容进行设置。
如何进行SQL优化	尽量避免使用LEFTJOIN或RIGHTJOIN，建议使用INNER。在使用LEFT或RIGHTJOIN时，ON会优先执行，WHERE条件在最后执行，所以在使用过程中，条件尽可能在ON语句中判断，减少WHERE的执行。尽量少用子查询，改用JOIN，避免大表全表扫描。
业务会长时间中断吗？	对业务连续性要求高的迁移，可以采用在线迁移的方式，并且选择选在业务量最低时进行业务切换，最大幅度降低业务切换对用户感受的影响。
通过外部镜像文件制作私有镜像过程中，需要对镜像完成哪些初始化配置？	通过外部镜像文件制作私有镜像过程中，需要对镜像完成初始化配置才能创建正常状态的私有镜像。如果上传的外部镜像文件已经完成了初始化设置，可以在注册镜像时勾选已完成镜像的初始化配置，注册后的私有镜像即为正常状态的私有镜像。使用外部镜像文件创建Linux操作系统私有镜像过程中，需要对镜像完成的初始化配置包括以下操作：查看并清理网络规则文件查看并设置网卡属性安装并配置Cloud工具具体操作请参考创建云服务器配置Linux云服务器以下相关步骤操作需要在云服务器内部完成，强烈建议您选择原有平台中导出镜像前的虚拟机实施修改操作。添加Linux操作系统自带的xen和virtio前端驱动到initrd或initramfs中。只需要添加module形式存在OS内的驱动，在内核中以build形式存在的驱动不需要添加。、CentOS、Oracle系列操作系统，以CentOS7为例，需修改文件，在add项中添加xen以及virtio的驱动驱动：xen、xen；virtio驱动：virtio、virtio、virtio、virtio、virtio、virtio，驱动名之间以空格隔开，保存并退出文件，执行dracut命令，重新生成initrd。修改在add项中添加xen和virtio的驱动具体格式要根据OS本身的要求来决定保存并退出文件，执行dracut命令，重新生成initrd。说明：如果引导的虚拟文件系统不是默认的initramfs或者initrd，则命令为实际使用的initramfs或者initrd文件名。实际使用的initramfs或者initrd文件名可在menu或者grub配置中获取。
消息在服务器保存多长时间？	保存72小时，超过72小时的消息会被删除。
CDN回源拉取资源的场景有哪些？	当CDN节点没有缓存用户请求的内容时，会回源拉取资源。当CDN节点上缓存的内容已过期时，会回源拉取资源。
域名解析的顺序是什么？	域名解析时，域名解析请求会优先查找匹配的子域名。如果子域名存在，则会从子域名的配置文件中查询解析结果。如果子域名不存在，则会从上一级域名的配置文件中查询解析结果。示例：假设用户创建域名example，并添加A类型的解析记录集www，然后创建子域名www，但未添加A类型的解析记录集www此时，如果访问www，解析请求会优先查找匹配子域名www。但是，由于未配置解析记录集，因此不会返回解析结果。
什么是服务依赖	服务依赖是指订购服务时必须先指定其依赖的服务实例。例如，服务A依赖服务B，如果被依赖的服务B实例还没有购买，则无法订购服务A的实例。服务依赖分被别人依赖依赖别人，使用时需要注意区分。
我可以存储哪种类型的数据？	我可以存储哪种类型的数据？显示一般性问题我可以存储哪种类型的数据？我可以存储哪种类型的数据？可以存储任何格式的任何类型数据。
服务开通后管理员没有收到邮件怎么办	开通服务后，管理员帐号及系统生成的密码，会通过邮件发送给管理员，如果没有收到该邮件，需要联系即时通信云服务的运维人员重置密码。公有云热线电话4000
我有多个磁盘想要邮寄，是否可以只创建一个服务单？	不可以，每个DES服务单只可以包含一块磁盘。若您想要邮寄多块磁盘，请为每块磁盘创建一个服务单。
为什么弹性云服务器可以远程连接，但是无法ping通？	需要在安全组中开启ICMP协议规则。
如何进入软件开发云各大服务首页？	软件开发云包括项目管理配置管理代码检查编译构建测试管理移动应用测试部署管理发布管理流水线服务，各服务首页入口如下：
向主题推送消息后，订阅者为什么没有收到消息？	订阅主题之后，订阅者会收到订阅确认通知。若未完成订阅确认，则向主题发布通知消息，该订阅者不会收到通知。
机器学习服务使用哪些安全防护？	机器学习服务基于VPC来控制用户、实例的网络安全隔离。用户对实例的访问则采用了SSL安全连接和安全算法套件，支持双向数字证书认证。同时在每个实例中对节点的操作系统进行安全加固，提高数据安全性。
文件系统支持Windows系统云服务器挂载吗？	文件系统暂不支持在Windows操作系统的云服务器上实现挂载，推荐使用Linux操作系统云服务器挂载共享路径，具体支持的操作系统类型参见约束与限制
哪些类型的网站适合使用OBS进行静态网站托管？	哪些类型的网站适合使用OBS进行静态网站托管？显示静态网站托管哪些类型的网站适合使用OBS进行静态网站托管？哪些类型的网站适合使用OBS进行静态网站托管？静态网站通常仅包含静态网页，以及可能包含部分可在客户端运行的脚本，如JavaScript、Flash等。
如果系统磁盘容量填写错误怎么办？	如果您通过镜像文件注册私有镜像时，填写的系统磁盘容量小于镜像文件内部的系统盘容量，在创建云服务器时可能会导致镜像文件中的数据无法写入，导致云服务器创建失败。如果出现此类情况，请您删除使用错误参数注册的镜像，并选择正确的配置参数重新创建私有镜像。
访问日志记录	显示访问日志记录访问日志记录
如何备份弹性云服务器？	目前弹性云服务器备份可以通过云硬盘备份功能实现。登录管理控制台。选择计算弹性云服务器进入云服务器列表页面。在左侧导航树中选择云硬盘备份单击创建云硬盘备份根据界面提示完成云硬盘备份。更多信息，请参见云硬盘备份用户指南
漏洞检测提供了哪些检测数据？	主机漏洞检测服务提供的检测数据包括：影响弹性云服务器的TOP7高危漏洞，漏洞分级统计详情，受高危漏洞影响的TOP7弹性云服务器的统计数据。数据来源：从当前时间开始计算，过去24小时内所有主机的扫描结果。
后台管理人员是否能获取到我邮寄磁盘中的数据？	华为数据中心管理人员在接收到您邮寄的磁盘后会直接挂载至服务器，且需要由您手工填写AK和加密密钥触发数据自动上传，华为人员全程不会接触密钥和数据。
已删除的弹性云服务器是什么意思？	这是一种弹性云服务器的中间状态。说明弹性云服务器已被正常删除，在该状态下的弹性云服务器，不能对外提供业务，将会在短时间内从系统中彻底清除。
如何安装MongoDB客户端	官网提供了针对不同操作系统的客户端安装包，下载MongoDB3。MongoDB官网二进制下载页面链接为：。下面将以RedHatLinux7为例介绍如何获取相应安装包及完成安装。操作步骤获取安装包。进入官网下载链接地址：选择，在中选择，单击。如图1所示。图1官网页面点击放大
使用消息通知服务发送短信的号码或别名可以保持一致吗？	可以。发送短信的号码或别名一般不会变，只有通道变化号码或别名才会变，通道变化是由于遇到运营商管控。
对象元数据	显示对象元数据对象元数据
Spark和Hadoop什么关系？	是和Hadoop数据兼容快速和通用的处理引擎。通过YARN，Spark可以在Hadoop集群下运行。Spark可以处理在HDFS、HBase、Hive以及Hadoop输入的任何形式的数据。
MRS是什么？	服务是公有云的一项基础服务，用于海量数据的管理和分析，简称MRS。打造了高可靠、高安全、易使用的运行维护平台，对外提供大容量的数据分析和计算能力，可解决各大企业的数据存储和处理需求。用户可以独立申请和使用托管Hadoop、Spark、HBase和Hive组件，用于快速在主机上创建集群，提供海量数据的实时性要求不高的批量数据分析和计算能力。
Windows弹性云服务器中的cloudbase	帐户是什么？弹性云服务器中的cloudbase帐户为Cloudbase代理程序的内置帐户，用于弹性云服务器启动的时候获取元数据并执行相关配置。如果删除此帐户，会影响云管理平台的相关功能，建议您不要修改、删除此帐户。如果自行修改、删除此帐户或者卸载Cloudbase代理程序，会导致由此云服务器创建的Windows私有镜像所生成的新云服务器初始化的自定义信息注入失败。说明：弹性云服务器中不存在该帐户。
什么情况下推荐使用DES？	根据可使用的广域网带宽，用户可以自己估算数据通过普通网络传输的传输时间，如果在自己预计的时间范围内数据不能传输完成则可考虑使用DES。数据传输时间计算公式如下：天数总容量KB每秒带宽Mbps网络使用率秒钟分钟小时
如何申请公测？	背景信息联络中心服务公测期间，开通服务需要申请公测资格。
能否跨VPC访问文件系统？	不能。文件系统只能在同一个VPC下的相同或不同可用分区间访问。
镜像的计费标准是什么？	镜像服务本身免费，不收取操作系统License费用，收取私有镜像存储费用。当前为试用阶段，您可以免费使用。
使用镜像创建云服务器，可以指定系统盘大小吗？	使用镜像创建云服务器，其系统盘大小不能任意指定，必须和镜像的系统盘大小相同。
地域之间是否存在产品差异？	暂时存在。我们会将成熟的产品服务部署在各个地域，新产品则会在部分地域做试点发布。
我对存储在OBS上的数据加密时，可支持哪些加密技术？	我对存储在OBS上的数据加密时，可支持哪些加密技术？显示安全性我对存储在OBS上的数据加密时，可支持哪些加密技术？我对存储在OBS上的数据加密时，可支持哪些加密技术？您在将数据上传到OBS中前，可以事先对数据进行加密，以保证传输和保存的安全性。OBS不限定客户端加密的技术。用户可根据需要对对象进行服务端加密，使对象更安全的存储在OBS中。需要上传的对象可以通过密钥管理服务器提供密钥的方式进行服务端加密。用户首先需要在KMS中创建密钥或者使用KMS提供的默认密钥，当用户在OBS中上传对象时使用该密钥进行服务端加密。当启用服务端加密功能后，用户上传对象时，数据会在服务端加密成密文后存储。用户下载加密对象时，存储的密文会先在服务端解密为明文，再提供给用户。支持通过接口提供KMS托管密钥的服务端加密和客户提供加密密钥的服务端加密两种方式，SSE方式是指OBS使用用户提供的密钥和密钥的MD5值进行服务端加密。接口相关详细信息请参见对象存储服务接口参考服务端加密章节。
使用SCSI类型的云硬盘是否需要安装驱动	云硬盘的磁盘模式默认为VBD类型，只支持简单的SCSI读写命令。SCSI类型的云硬盘支持SCSI指令透传，允许云服务器操作系统直接访问底层存储介质。除了简单的SCSI读写命令，SCSI类型的云硬盘还可以支持更高级的SCSI命令。使用SCSI类型的云硬盘时，需要为某些云服务器操作系统安装驱动，具体如下：的操作系统中已经预安装了使用SCSI类型云硬盘所需的驱动，无需安装。当ECS的操作系统为Windows时，具体请参见表1表1类型云硬盘支持的Windows云服务器镜像操作系统是否需要安装驱动备注公共镜像表格中的Windows公共镜像的操作系统中已经预安装PVSCSI驱动，无需再安装。私有镜像表格中的Windows私有镜像的操作系统中未安装PVSCSI驱动，请您自行下载并安装驱动，具体方法请参见镜像服务用户指南中的在Windows系统中安装Tools小节。其他操作系统表格中未列出的其他操作系统不支持使用SCSI类型云硬盘。
什么是UQuery	是一种云上完全托管的数据查询服务，用户不需要管理任何服务器，也无需关心服务集群的安装、扩容和升级等操作，在开通服务之后，无需启动，即开即用。支持标准SQL接口，兼容主流的数据格式，支持界面以及接口具备计算资源隔离和数据细粒度权限控制能力，用户可以使用UQuery服务对云上多数据源进行分析探索。
什么是节点？	每一个节点对应一台虚拟机，容器应用运行在节点上。节点上运行着代理程序，用于管理节点上运行的容器实例。节点规格最小是CPU为1core，内存为2048MB；最大是CPU为32core，内存为128GB。
移动客户端已添加的联系人为何在PC客户端看不到？	手动添加的联系人信息将保存在当前使用的客户端本地，不会进行数据同步。
使用RDS要注意些什么	故障切换采用高可用模式，当主机出现故障时，RDS会在1分钟切换到备机，切换过程中不可访问，需要您设置好程序跟RDS的自动重连，避免因为切换导致服务不可用。实例的操作系统，对用户都不可见，这意味着，只允许用户应用程序访问数据库对应的IP地址和端口。使用的ECS以及OBS上的备份文件，都对用户不可见，它们只对RDS后台管理系统可见。申请RDS后，您还需要做什么申请RDS实例后，您不需要进行数据库的基础运维比如高可用、安全补丁等，但是您还需要重点关注以下事情：实例的CPU、IOPS、空间是否足够，如果不够需要变更规格或者扩容。实例是否存在性能问题，是否有大量的慢SQL，SQL语句是否需要优化，是否有多余的索引或者缺失的索引等。
每个用户可以创建多少队列？	每个用户默认最多可以创建五个队列，如果您想创建更多队列，请联系客服申请增加配额。
服务单状态是“传输失败”是什么意思？	传输失败是什么意思？当您填写AK和加密密钥启动数据上传后，若校验失败将会导致服务单状态变为传输失败以下几种情况会出现传输失败情况，请根据实际情况排查解决后，重新填写AK启动上传。或加密密钥填写错误，请重新尝试填写正确的AK和加密密钥。服务单中填写的磁盘目录与邮寄的磁盘中的目录不一致。此时请修改服务单中的磁盘目录，使之与邮寄的磁盘中的目录保持一致。磁盘签名文件未按照要求存放在磁盘根目录。此时数据中心管理员将会联系您，并将磁盘寄回，您需要重新按要求存放磁盘签名文件后再寄出。
MRS可以做什么？	基于开源软件Hadoop进行功能增强、Spark内存计算引擎、HBase分布式存储数据库以及Hive数据仓库框架，提供企业级大数据存储、查询和分析的统一平台，帮助企业快速构建海量数据信息处理系统，可解决各大企业的以下需求：海量数据的分析与计算海量数据的存储
软件开发云中如何查看用户使用量？	说明：用户使用量为各个服务的资源使用情况。
通过专线接入后，是否可以访问不同的VPC？	单条专线目前只能访问单个VPC。但是，专线创建完成后，可根据需要联系管理员修改VPC，以达到在不同时间对多个VPC的访问。
如何选择地域？	地域是一个地理区域的概念。我国地域面积广大，由于带宽的原因、不可能只建设一个数据中心为全国客户提供服务。因此，我们根据地理区域的不同将全国划分成不同的地域。选择地域时通常根据就近原则进行选择，例如您或者您的客户在北京，那么您可以选择华北服务区，这样可以减少访问服务的网络时延，提高访问速度。
有哪些途径可以使用AIS的API？	共有三种方式可以基于已构建好的请求消息发起请求。是一个命令行工具，用来执行各种URL操作和信息传输。cURL充当的是HTTP客户端，可以发送HTTP请求给服务端，并接收响应消息。cURL适用于接口调试。关于cURL详细信息请参见编码通过编码调用接口，组装请求消息，并发送处理请求消息。客户端、Google都为REST提供了图形化的浏览器插件，发送处理请求消息。针对Firefox，请参见针对Chrome，请参见
是否可以进一步提升图像去雾和低光照处理效果？	默认参数可保证在大多数情况下能取得比较好的处理效果，若要进一步提升效果，需要通过调整相关参数，选取最佳效果
每个主题最多支持多少个订阅者？	公测期间，每个主题最多支持10000个订阅者。每个主题最多支持10000个订阅者。
已删除的裸金属服务器可以再开通吗？	删除过程中的裸金属服务器不能被再次开通，彻底被清除的裸金属服务器可以再次开通使用。
OBS支持哪些存储类别？	支持哪些存储类别？显示一般性问题支持哪些存储类别？支持哪些存储类别？对象存储服务设置有如下存储类别，分别为：标准存储、低频访问存储、归档存储，从而满足客户业务对存储性能、成本的不同诉求。标准存储拥有低访问时延和较高的吞吐量，因而适用于有大量热点文件平均一个月多次或小文件，且需要频繁访问数据的业务场景，例如：大数据、移动应用、热点视频、社交图片等场景。低频访问存储适用于不频繁访问平均一年少于12次但在需要时也要求快速访问数据的业务场景，例如：文件同步共享、企业备份等场景。与标准存储相比，低频访问存储有相同的数据持久性、吞吐量以及访问时延，且成本较低，但是可用性略低于标准存储。归档存储适用于很少访问平均一年访问一次数据的业务场景，例如：数据归档、长期备份等场景。归档存储安全、持久且成本极低，可以用来替代磁带库。为了保持成本低廉，数据取回时间可能长达数分钟到数小时不等。
什么是命名空间？	命名空间类似于资源名称的前缀，帮助不同的应用共享同一个集群，例如防止不相关的应用之间的名称冲突。
什么是云服务器协议（端口）？	端口后端云服务器自身提供的网络服务的协议以及协议的端口，如使用windows操作系统上安装的IIS，该服务默认的协议为HTTP，端口为80。
什么是对象？	什么是对象？显示一般性问题什么是对象？什么是对象？对象是OBS中数据存储的基本单位，一个对象实际是一个文件的数据与其相关属性信息元数据的集合体。用户上传至OBS的数据都以对象的形式保存在OBS的桶中。对象包括了Key，Metadata，Data三部分：：键值，即对象的名称，为经过UTF编码的长度大于0且不超过1024的字符序列。一个桶里的每个对象必须拥有唯一的对象键值。：元数据，即对象的描述信息，包括系统元数据和用户元数据，这些元数据以键值对的形式被上传到OBS中。系统元数据由OBS自动产生，在处理对象数据时使用，包括Date，Content，Last，Content等。用户元数据由用户在上传对象时指定，是用户自定义的对象描述信息。：数据，即对象的数据内容。
流水线各角色类型对应的操作权限是什么？	流水线中用户的角色类型及对应的操作权限说明，如表1所示。表1角色类型及操作权限角色操作流水线任务构建包通知项目创建者全部权限：新建、修改、删除、查看、执行任务下载构建包设置消息通知项目经理全部权限：新建、修改、删除、查看、执行任务下载构建包设置消息通知测试经理开发人员新建、修改、查看、执行任务删除自己的任务
屏幕共享不成功	、享前需要先入会并加载模块成功。、共享前需要获取共享的权限，并收到通知。
什么是环境变量？	环境变量是指容器运行环境中设定的一个变量，您可以在创建容器模板时设定不超过30个的环境变量
如何确保在VPC中运行的RDS实例的安全	安全组可用来帮助确保VPC内RDS实例的安全。此外，通过网络访问控制列表，可以允许或拒绝进入和退出各个子网的网络流量。
单个用户支持保有多少个弹性负载均衡？	单个用户默认支持保有5个弹性负载均衡。如果需要创建更多弹性负载均衡，请填写工单申请更高配额，申请的弹性负载均衡个数不超过255个。提交工单的步骤如下。在管理控制台右上角单击用户名，选择提交工单进入提交工单页面，按照界面提示选择云服务区、业务类型、问题模板，输入问题描述等信息。单击提交
云监控能监控哪些指标？	云监控目前支持监控的指标，如表1所示。表1监控指标服务名称监控指标数量监控指标名称弹性云服务器如果用户使用的镜像已安装vmtools，则可获取到监控指标的个数为12。如果用户使用的镜像未安装vmtools，则可获取到监控指标的个数为10。如果用户使用的镜像已安装vmtools，则可获取到如下监控指标：使用率、磁盘读速率、磁盘读操作速率、磁盘使用率、磁盘写速率、磁盘写操作速率、内存使用率、带内网络流入速率、带内网络流出速率、带外网络流入速率、带外网络流出速率、系统状态检查失败。如果用户使用的镜像未安装vmtools，则可获取到如下监控指标：使用率、磁盘读速率、磁盘读操作速率、磁盘写速率、磁盘写操作速率、带内网络流入速率、带内网络流出速率、带外网络流入速率、带外网络流出速率、系统状态检查失败。云硬盘磁盘读速率、磁盘写速率、磁盘读操作速率和磁盘写操作速率。弹性伸缩使用率、内存使用率、实例数、网络流入速率和网络流出速率。弹性负载均衡并发连接数、活跃连接数、非活跃连接数、新建连接数、流入数据包数、流出数据包数、网络流入速率、网络流出速率、异常主机数和正常主机数。虚拟私有云上行带宽、下行带宽、上行流量、下行流量。分布式缓存服务利用率、内存利用率、网络输入吞吐量、网络输出吞吐量、活跃的客户端数量、客户端最长输出列表、客户端最大输入缓冲、阻塞的客户端数量、已用内存、已用内存RSS、已用内存峰值、Lua已用内存、内存碎片率、总共收到的连接数、总共处理的命令数、每秒并发操作数、网络总共收到字节数、网络总共发送字节数、网络瞬时输入流量、网络瞬时输出流量、已拒绝的连接数、全量同步次数、增量同步成功次数、增量同步出错次数、已过期的键数量、已挤出的键数量、Keyspace命中次数、Keyspace错过次数、Pubsub通道个数、Pubsub模式个数、AOF文件当前大小和最近Fork耗时。关系型数据库磁盘使用率、CPU利用率、内存利用率、IOPS、网络输入吞吐量、网络输出吞吐量、数据库总连接数、当前活跃连接数、QPS、TPS、缓冲池利用率、缓冲池命中率、缓冲池脏块率、InnoDB读取吞吐量、InnoDB写入吞吐量、InnoDB文件读取频率、InnoDB文件写入频率、InnoDB日志写请求频率、InnoDB日志物理写频率、InnoDB日志fsync写频率、临时表数量、KeyBuffer利用率、KeyBuffer写命中率、KeyBuffer读命中率、MyISAM硬盘写入频率、MyISAM硬盘读取频率、MyISAM缓冲池写入频率、MyISAM缓冲池读取频率、Delete语句执行频率、Insert语句执行频率、Insert语句执行频率、Replace语句执行频率、Replace语句执行频率、Select语句执行频率、Update语句执行频率、行删除速率、行插入速率、行读取速率、行更新速率、事务日志使用量、复制插槽使用量、数据库连接数、事务最大已使用ID数、事务日志生成速率、最滞后副本的滞后量、复制时延、磁盘总大小、磁盘使用量、磁盘读吞吐量、磁盘写吞吐量、磁盘读耗时、磁盘写耗时、磁盘平均队列长度、使用中的数据库连接数。分布式消息服务消息堆积数、已消费消息数、跳跃消费消息数、队列消息数、消息大小、消息请求数、死信消息堆积数、死信历史消息数。应用防火墙注入告警个数、XSS跨站脚本漏洞告警个数、Webshell上传告警个数、盗链告警个数、IP黑名单告警个数、IP白名单告警个数。主机漏洞检测高危漏洞个数、中危漏洞个数、低危漏洞个数。云桌面使用率、内存使用率、磁盘使用率、IOPS、网络输入吞吐量、网络输出吞吐量。机器学习服务使用率、内存使用率、磁盘使用率。网页防篡改网页防篡改告警个数。数据仓库服务缓存命中率、内存中排序比率、文件读取次数、文件写入次数、每秒文件读取次数、每秒文件写入次数、数据量大小、活跃SQL数、会话数、CPU使用率、内存使用率、IOPS、网络输入吞吐量、网络输出吞吐量、磁盘利用率、磁盘总大小、磁盘使用量、硬盘读吞吐量、硬盘写吞吐量、硬盘读耗时、硬盘写耗时、磁盘平均队列长度。人工智能服务调用单据识别成功次数和调用单据识别失败次数。
重装操作系统时是否可以选择其他操作系统？	重装操作系统只支持使用原镜像进行系统重装，不支持使用新的系统镜像。如需使用新的系统镜像，请参见切换弹性云服务器的操作系统
我可以使用事件通知做什么？	我可以使用事件通知做什么？显示事件我可以使用事件通知做什么？我可以使用事件通知做什么？您可以通过事件通知发送警报或触发工作流，并通过消息通知服务：SimpleMessageNotification发送通知。目前，OBS支持发布以下事件：使用Put方法上传对象。使用Post方法上传对象。使用APIs等工具复制对象。目前OBS管理控制台和OBS客户端暂时不支持对象复制功能。分段上传对象。指定对象版本号删除对象。不指定对象版本号删除对象。您可以将通知配置为按对象名称的前缀和后缀进行筛选。例如，您可以添加一个事件，以便仅在将带有后缀的图像文件添加到存储桶时收到通知。或者，您也可以添加一个事件，该配置仅在将带有前缀为的对象添加到存储桶时收到通知。
如何以单用户模式登录Linux弹性云服务器重置密码？	操作场景弹性云服务器系统密码涉及到客户重要的私人信息，提醒您妥善保管密码。对于Linux弹性云服务器，如果密码丢失，可以通过系统提供的重置密码功能找回密码，或者以单用户模式登录弹性云服务器重置密码。其中：通过系统提供的重置密码功能找回密码，请参见重置弹性云服务器的密码如果您擅长使用单用户模式登录Linux弹性云服务器，请参见本节内容。
为什么在VPC中使用DDS	允许您在私有、隔离的网络创建虚拟网络环境，从中可以对私有IP地址范围、子网、路由表和网络网关等方面进行全面控制。借助VPC，您可以定义虚拟网络拓扑和网络配置，使其非常类似于您在自己的数据中心所操作的传统IP网络。在下面的情况下您可能想在VPC中使用您希望运行面向公众的Web应用程序，同时保留公众不可访问的后端服务器。您可以在一个VPC内同时创建一个实例和ECS实例，同时为ECS实例分配公网IP，将Web服务器部署在ECS实例。
如何找回会议用户密码？	会议用户密码？登录会议管理系统单击忘记密码帐号名中填写会议用户帐号，使用注册邮箱的方式找回，单击获取重置链接，如图1所示。系统将会以邮件的形式将重置密码的链接发送至会议用户帐号关联的注册邮箱。图1找回密码
软件开发云中如何对项目成员进行计费？	项目成员数发生变化如何计费项目成员数发生变化如何计费，如表1所示。表1计费规则计费规则示例软件开发云是根据当前系统使用量进行计费的：免费额度以内的项目成员，不计费。新增项目成员，超出免费额度的开始计费，按照单价计算超出部分的使用费用。移除项目成员，停止对被移除成员的计费。
MRS当前支持哪些规格主机？	根据丰富的大数据产品调优经验，提供不同场景对应的最佳搭配。MRS当前支持以下规格主机，主机规格的配型由CPU内存共同决定：云主机：4核内存：16GB：40GB云主机：8核内存：16GB：40GB云主机：16核内存：32GB：40GB云主机：16核内存：64GB：40GB云主机：32核内存：128GB：40GB云主机：16核内存：128GB：1云主机：36核内存：256GB：1核32G服务：8核内存：32GB：40GB主机的实例规格配置越高，数据处理分析能力越强，集群所需费用也越高，请根据您要处理的数据量选择主机配型。
RDS支持读写分离吗	支持读写分离，一个RDS集群中最多可创建5个只读副本。目前不支持Proxy代理，需要在应用侧配置判断和分配读写请求，自行寻址。不支持读写分离。
CloudStream有哪些特点和优势？	的主要特点和优势在于：丰富的StreamSQL在线分析能力支持window、join等聚合函数，用SQL表达业务逻辑，简便快捷实现业务。分布式实时计算支持大规模集群计算，集群弹性伸缩，最大化节省成本。易用在SQL编辑平台写StreamSQL，StreamSQL定义数据流入、数据处理、数据流出，快速便捷实现业务逻辑，降低流数据分析门槛。全托管用户完全不感知计算集群，对运行的作业可视化查看运行状态。开箱即用不再关心各种大数据框架，写StreamSQL，即时运行作业。按需计费定价单位是SPU，用户选定SPU数，按照时长收费，精确到秒。安全隔离租户三重安全机制保障，确保作业安全运行，且租户计算集群完全和其他租户物理隔离，独立的安防设置，确保计算集群的安全性。高吞吐低时延从DIS中读取数据，服务支持自然反压机制，支持高吞吐压力；毫秒级延迟，满足实时计算的业务场景。
什么是DataSource?	表示数据管道操作中被处理的数据，举例来说，一个OBSdatasource表示存放在OBS中的数据，它的path属性，表示了数据的存放路径。
数据仓库服务可以做什么？	数据仓库服务为用户提供一种即开即用、安全可靠的在线数据仓库服务，可以部署任意OLAP数据分析业务，如企业数据仓库，数据集市等。
云专线是否支持续订？怎么续订?	在管理控制台右上角单击用户名称。单击我的订单单击需要续订的订单所在行操作列下的详情进入订单详情页面。单击续订确认续订信息，单击提交如果无续订按钮，请联系技术支持。
如何使用华为云提供的openSUSE镜像源？	操作场景用户需要更新弹性云服务器的系统或者软件时，可以连接Internet，通过外部openSUSE镜像源提供相关服务。但是，如果弹性云服务器无法访问Internet，或者外部openSUSE镜像源提供的服务不稳定时，可以使用华为云提供的openSUSE镜像源进行更新。
每个帐户最多可以创建多少个文件系统？	目前每个帐户可创建最多10个共享文件系统，且支持同时创建，单个文件系统最大使用容量为512000GB。
CentOS6.5系统如何添加静态路由？	操作场景为系统添加静态路由，避免重启系统后路由丢失而影响到网络可用性。
数据超过了DDS实例的最大存储容量怎么办	如果您的应用程序所需的存储容量超过最大分配量，解决措施如下：扩容存储空间。增加shard分片。
我是否需要将磁盘签名文件随磁盘一起邮寄？	是的。创建服务单后，请下载磁盘签名文件放入待邮寄磁盘的根目录，且不要对磁盘签名文件进行加密。
M	公测期间是不收取费用的，您可以免费使用M服务。公测后收取相应费用，费用每小时费率主节点数使用时长每小时费率核心节点数使用时长
主题创建者是否可以控制他们所创建的主题中允许的传输协议？	暂不支持主题传输协议的设置。
什么是服务凭证	服务实例创建之后，如果要访问这个服务实例，都需要知道它的详细信息。这些信息不仅仅是地址和端口，更多的是业务上属性，比如服务实例的账号信息：用户名，密码，key文件等。这类实例的访问信息叫做服务访问凭证。常见的凭证格式有：服务数据库主机名或地址数据库端口号数据库名称数据库用户名数据库密码服务服务
如何自动部署我的应用？	您需要在创建私有镜像前，在源云服务器中安装应用，并设置开机自动启动。弹性伸缩组页签，单击伸缩组名称，在配置名称栏查看该伸缩组使用的伸缩配置详情。确认该伸缩配置选择的镜像是否为中创建的私有镜像。是，结束。弹性伸缩添加的云服务器可以自动部署您的应用了。否，执行创建一个新的伸缩配置，确认该伸缩配置选择的镜像即为中创建的私有镜像。弹性伸缩组页签，单击伸缩组名称，并在配置名称栏单击修改，将该伸缩组的伸缩配置变更为中新创建的伸缩配置。
可用分区之间的数据传输是否需要收费？	同一地域下的可用分区不收费，跨地域的可用分区则需要收费。
切换操作系统是否需要收费？	公有云平台免费为您提供弹性云服务器的切换操作系统功能。切换后，系统将根据您选择的产品重新计费，具体收费请参见产品价格详情
为什么云监控服务中的网络流量指标值与弹性云服务器系统内工具检测的指标不同？	因为云监控服务与弹性云服务器系统内指标检测软件的采样周期不同。云监控服务对弹性云服务器、云硬盘的采样周期是4分钟，而系统内工具的采样周期一般为1秒，远远小于云监控服务的采样周期。采样周期越大，短期内的数据失真越大。所以云监控更适合用于网站长期监测、长期监测运行在弹性云服务器内的应用趋势等。同时，使用云监控服务用户可通过设置阈值对资源进行提前告警，保证资源稳定可靠。
我的数据存储在哪里？	我的数据存储在哪里？显示一般性问题我的数据存储在哪里？我的数据存储在哪里？在OBS上创建桶时，您可以指定一个区域。在该区域内，您的数据存储在多台设备上。
CDN支持哪些业务类型？	不同业务类型的加速配置存在一定差异，当前支持以下方式：网站加速文件下载加速点播加速直播加速内测中，支持线下配置，需要提交工单申请
如何分辨针对性攻击和普通攻击？	可通过安全态势感知里的攻击者态势分析来分辨：攻击者态势界面，单击攻击者ID。查看该攻击者的攻击情况分析，查看攻击本用户和云平台的攻击次数以及目标个数所占比例，如图1所示。图1攻击情况分析点击放大
DIS有哪些模块及各模块功能？	服务控制面完成服务的开通、删除、配置操作，并将用户信息同步到数据面。完成数据面资源的申请与自动部署。服务数据面接收用户发送的请求，对已鉴权的数据接收并存储。接收用户获取数据的请求，在鉴权后输出对应的用户数据。按时老化存储在系统中的用户数据。根据用户配置，将用户数据存储到OBS。服务维护负责服务的安装、升级。负责服务的配置、巡检、日志收集与分析、运行监控。负责服务工单处理。用户SDK提供Java接口，供用户上传与下载数据。提供数据加密功能。
为什么创建队列时提示账号受限？	当租户余额小于100人民币时，无法创建队列，如需继续使用分布式消息服务，请为帐户充值。
我能创建和使用多少个伸缩策略和配置？	您默认可以创建10个弹性伸缩组，100个弹性伸缩配置。每个弹性伸缩组同一时刻支持使用1个伸缩配置，10个伸缩策略。如果系统提供的默认配额不能满足您的需求，请联系管理员进行处理。
为什么安全指数服务显示的概况与实际的配置不同？	如果用户刚进行了安全配置的修改，可以单击各个安全子项概况右上角的，以便后台立即对数据进行刷新及重新进行评估。
弹性伸缩服务是否收取费用？	弹性伸缩服务本身不收取费用。但会按伸缩组内的云服务器实例收取云服务器的费用。
加密镜像如何共享或者发布为市场镜像？	目前，加密镜像不允许共享或者发布为市场镜像，如果用户想要将某个加密的私有镜像共享或者发布为市场镜像，可以通过复制镜像功能，将该镜像复制为一个非加密的新镜像，再共享该非加密镜像共享或者将该非加密镜像发布为市场镜像。
华为云迁移都支持什么场景？	华为业务迁移解决方案主要分为如下场景：传统物理设备到云平台其他公司虚拟化平台到华为云平台华为云平台内部迁移。
数据存储在OBS和HDFS有什么区别？	集群处理的数据源来源于OBS或HDFS，HDFS是Hadoop分布式文件系统，OBS即对象存储服务，是一个基于对象的海量存储服务，为客户提供海量、安全、高可靠、低成本的数据存储能力。MRS可以直接处理OBS中的数据，客户可以基于云管理平台Web界面和OBS客户端对数据进行浏览、管理和使用，同时可以通过RESTAPI接口方式单独或集成到业务程序进行管理和访问数据。数据存储在OBS：数据存储和计算分离，集群存储成本低，存储量不受限制，并且集群可以随时删除，但计算性能取决于OBS访问性能，相对HDFS有所下降，建议在数据计算不频繁场景下使用。数据存储在HDFS：数据存储和计算不分离，集群成本较高，计算性能高，但存储量受磁盘空间限制，删除集群前需将数据导出保存，建议在数据计算频繁场景下使用。
支持哪几种开具发票模式？	系统支持按按到款开具发票按账期开具发票按订单开具发票模式，您可在管理控制台的用户中心自行选择。
服务单状态是“已过期”是什么意思？	已过期是什么意思？当从创建DES服务单开始，如果数据中心管理员在30天内都未接收到磁盘，服务单状态会自动由待寄送磁盘转换为已过期
专属云下购买云服务器与非专属云下购买云服务器有什么不同？	专属云下购买云服务器仅支持按需购买云服务器，不支持包周期购买云服务器。专属云下购买云服务器时，计算资源不计费，使用用户已购买的设备节点剩余的计算资源。如果计算资源不足，则不能继续购买云服务器。
每个主题最多支持多少个订阅者？	每个主题最多支持10000个订阅者。
什么是本地进程？	本地进程，即当前用户弹性云服务器中所有处于运行中的程序。
如何访问云容器引擎？	云容器引擎提供了Web化的服务管理平台，即管理控制台和基于HTTPS请求的API管理方式。方式用户可以通过调用API访问云容器引擎，具体操作请参见云容器引擎接口参考管理控制台方式如果用户已注册云容器引擎，可直接登录管理控制台，从主页选择云容器引擎
密集存储型/高计算型弹性云服务器的网卡无法正常工作，怎么办？	高计算型弹性云服务器的网卡无法正常工作，怎么办？问题描述在使用密集存储型高计算型弹性云服务器时，网卡无法正常工作。
我在什么场景下需要使用跨域资源共享？	我在什么场景下需要使用跨域资源共享？显示跨域资源共享我在什么场景下需要使用跨域资源共享？我在什么场景下需要使用跨域资源共享？使用OBSCORS配置的典型应用场景包括：通过CORS支持，使用JavaScript和HTML5来构建Web应用，直接访问OBS中的资源，而不再需要代理服务器做中转。使用HTML5中的拖拽功能，直接向OBS上传文件，展示上传进度，或是直接从Web应用中更新内容。托管在不同域中的外部网页、样式表和HTML5应用，现在可以引用存储在OBS中的Web字体或图片，让这些资源能被多个网站共享。
ECS无法连接到DDS实例的原因	遇到该问题，请参考以下步骤排查解决。先确认ECS实例和实例是否在同一个VPC。如果在，执行如果不在，需要重新创建ECS实例，使之和实例在同一个VPC下。查看ECS实例是否添加安全组。如果有，检查安全组的配置规则是否满足要求，详见购买数据库实例章节安全组的描述，然后执行如果没有，从ECS的实例详情页面，进入VPC页面，选择安全组，添加安全组。在弹性云服务器ECS上，测试是否可以正常连接到实例地址的端口。mongos的默认端口为8635。实例地址如果可以通信，说明网络是正常的，请检查数据库用户和密码，详见连接数据库实例如果端口不通，请联系售后技术支持协助排查。
事件文件可以存储多长时间？	默认情况下，云审计服务管理控制台可存储最近7天内的事件文件，而对于已保存至OBS桶的历史操作记录，您可以无限期存储这些事件文件。
如何修改Windows弹性云服务器网卡的MTU值？	最大传输单元是指一种通信协议的某一层上所能通过的最大数据报大小，取值范围1280，以字节为单位。以Windows2012为例，介绍Windows弹性云服务器网卡的MTU值的修改方法。开启网卡的JumboPacket。单击开始菜单，打开控制面板图1控制面板点击放大
如何绑定弹性IP？	可以通过申请弹性IP并将弹性IP绑定到弹性云服务器上，实现弹性云服务器访公网的目的。操作步骤登录控制台。在系统首页，选择网络虚拟私有云在左侧导航树，单击弹性IP单击申请弹性IP操作步骤请参考帮助中心虚拟私有云用户指南管理为弹性云服务器申请和绑定弹性IP说明：在绑定IP时，选择一台云服务器，应用即可被外网访问。
为什么要采用mysqldump/pg_dump工具迁移	工具迁移该方案优点是简单，容易上手，缺点是停机时间较长。因此它适用于数据量不大，或者允许停机的时间较长，并且在这个时间范围内能够完成的数据。由于RDS提供的关系数据库服务与原来的数据库服务是完全兼容的，所以对于用户来说，从原有数据库迁移到RDS数据的过程，与从一台数据库服务器迁移到另外一台数据库服务器的过程基本类似。
怎么解决查询运行缓慢的问题	可以通过查看慢查询日志来确定是否存在运行缓慢的查询，以及各个查询的性能特征如果有的话，从而定位查询运行缓慢的原因。查询日志，请参见慢查询日志您还可以查看实例的CPU使用率指标，协助定位问题，请参见使用CES监控
云服务器变更（添加、删除、扩容云硬盘）后能否使用备份恢复数据？	添加、删除、扩容云硬盘后能否使用备份恢复数据？如果您的云服务器做过备份后进行变更，还可以使用原有的备份恢复数据。但因为文件系统的限制，恢复数据后，云硬盘恢复为未变更前的状态，建议您在变更后重新做备份。
为什么查看事件窗口中，有些事件的IP、code、request、response和message字段为空？	、code、request、response和message字段并非必选信息：：当tracetype为SystemAction时，表示本次操作由服务内部触发，此时缺失IP字段为正常情况。：这三个字段是表示本事件所对应的API在调用HTTP请求时发送和接受到的body体和code码，内容由发送事件的云服务决定，缺失为正常情况。：该字段为预留给各云服务自身记录备注信息所用，内容由发送事件的云服务决定，缺失为正常情况。
分布式缓存服务是否支持修改配置参数？	处于运行中状态的缓存实例支持修改配置参数，集群实例暂不支持修改密码。
云报表服务支持哪些MySQL数据类型？	云报表服务支持的MySQL数据类型如表1所示。表1数据类型与云报表服务数据列类型对应关系数据类型云报表数据列类型
通过控制台可以修改哪些参数项（PostgreSQL）	允许通过控制台修改的参数项如下：的可配置参数如表1所示。的可配置参数，在表1的基础上新增表2说明：系统提供的默认参数组不允许修改，只可单击操作列中的查看进行查看。当用户参数设置不合理导致数据库无法启动时，可参考默认参数组重新配置。
Anti	在访问数据流量不超过自动限流触发值的场景下，提供DDoS攻击防护。对于正常业务访问流量超过自动限流触发值的应用，系统会进行自动限流措施正常访问流量会丢失。此场景下，建议用户自主购买第三方清洗中心服务，从第三方获取报表。说明：自动限流触发值由云服务器所在的服务区确定，具体值请查看实例IP的监控报表。
我是否可以对磁盘进行加密后再邮寄？	可以，DES支持使用第三方加密工具Truecrypt对数据进行加密。对磁盘加密后，请务必自行保管好加密密钥，并在启动数据上传时正确输入。如果密钥丢失，则无法解密您的数据。
如何使用部署管理？	部署服务提供可视化、一键式部署服务，支持并行部署和流水线无缝集成，实现部署环境标准化和部署过程自动化。
登录OBS管理控制台访问的OBS资源与登录OBS客户端访问的OBS资源是否相同？	登录OBS管理控制台访问的OBS资源与登录OBS客户端访问的OBS资源是否相同？显示安全性登录OBS管理控制台访问的OBS资源与登录OBS客户端访问的OBS资源是否相同？登录OBS管理控制台访问的OBS资源与登录OBS客户端访问的OBS资源是否相同？相同，用户通过帐户密码登录OBS管理控制台后，可在我的凭证页面创建该帐户对应的AK和SK，若用户使用该AK和SK登录OBS客户端，访问到的OBS资源与通过登录OBS管理控制台访问到的OBS资源相同。
ELB公网IP是否有并发连接数限制？	系统默认的ELB公网IP并发连接数为十万。如果需要更多并发连接数，请提交工单申请扩大并发连接数。提交工单的步骤如下。在管理控制台右上角单击用户名，选择提交工单进入提交工单页面，按照界面提示选择云服务区、业务类型、问题模板，输入问题描述等信息。单击提交
FunctionStage支持哪些编程语言？	目前支持的编程语言有Node、Python、Java。
为什么创建实例时提示帐号受限？	当租户余额小于100人民币时，无法创建实例，如需继续使用分布式缓存服务，请为帐户充值。
主备同步存在多长时间的延迟	主机与备机的同步延迟是无法利用公式来计算的，它会受到以下因素的影响：网络通信状况。主机的事务压力，即主机每秒执行的事务量。主机执行的事务大小，即一个事务要执行多久。备机和只读副本的机器负载状况。如果主机在某个时间段压力非常大，每秒执行的事务量非常多，备机通常会出现延迟。反之，延迟一般都是秒级。对于MySQL，可以在实例管理页面，展开HA集群下备机的详细信息，其中，复制源为该集群下的主机，在复制状态正常的情况下，通过查看复制时延，来获取当前主备同步延迟值。对于PostgreSQL，可以通过CES页面查看监控指标复制时延，来获取当前主备同步延迟值。具体的查看方法，请参见通过CES监控对于MicrosoftSQLServer，目前无法查看。
如何将用户程序提交到MRS中？	为用户提供程序执行平台，程序由用户自身开发，MRS负责程序的提交、执行和监控。那如何将用户程序提交至MRS中呢？新增作业时，将执行程序路径参数配置为用户程序的实际存放路径，如图1所示。图1新增作业点击放大
如何使用TrueCrypt工具对我待邮寄的磁盘进行加密？	您需要先从华为云开发者中心获取与您操作系统相匹配的工具版本，然后安装TrueCrypt并对数据进行加密。具体的工具安装和加密数据方法可参见数据快递服务用户指南
什么是云专线服务？	云专线服务是一个建立连接本地数据中心和云平台的专线网络服务。您可以利用云专线建立云与数据中心、办公室或主机托管区域的专线连接，降低网络时延，获得比Internet线路更好的网络体验。目前云专线仅支持MPLSVPN类型专线。
软件开发云支持哪些开发环境？	软件开发云支持的开发环境类型，如表1所示。说明：软件开发云支持的浏览器类型如下：及以上版本及以上版本及以上版本
云容灾解决方案faq	显示云容灾解决方案FAQ云容灾解决方案FAQ：华为云能提供哪些容灾解决方案？：华为容灾解决方案包括：主备容灾，双活容灾，两地三中心容灾。这里主要介绍的是基于华为云平台的主备容灾方案。如果您有双活容灾需求，我们将根据实际情况进行评估是否适合用华为云平台实现。：华为云容灾方案是基于哪种容灾技术实现？：云容灾方案即提供客户自有DC通过远程复制的技术将业务集中容灾到华为云，主要推荐采用华为自研存储的复制技术构建主备容灾系统。：容灾系统部署在华为云上的不同之处主要体现在哪些方面？：客户不需要独立建设容灾中心；在华为云上建设的容灾系统可以独享安全的网络和主机资源；容灾切换后，即容灾中心接管生产业务后，可根据弹性策略快速增加云主机。：容灾管理服务器的部署位置在生产中心还是容灾中心？：对部署在生产中心和容灾中心无特殊要求。一般推荐部署在容灾中心，即华为云上。如果客户将容灾管理服务器部署在生产中心，当生产中心故障时，容灾管理服务器也故障或者管理网络与容灾中心不连通，此时如果需要故障恢复，容灾管理服务器不能下发指令，客户只能通过手动操作进行故障恢复，手动操作时间长，容易出错，因此不推荐部署在生产中心。：容灾复制过程中链路发生故障，如何保障数据一致性？：容灾是以恢复业务应用为目标，必须尽可能地保持业务应用数据的一致性，以便能够在灾害发生时有效的保存即时数据，从而对原有应用进行恢复。华为主备容灾方案在应对容灾复制链路故障时，针对不同的场景均可有效保障生产中心和容灾中心的数据一致性：复制链路故障，生产中心业务正常。可通过华为主备容灾方案的断点续传功能保障数据一致性。当容灾复制过程中链路发生故障，生产中心会记录数据传输断点；链路恢复时，从复制中断点继续传输数据，保证生产中心和容灾中心的数据一致性。复制链路故障，同时生产中心故障。业务需要从生产中心切换到容灾中心运行；容灾中心通过快照自动回滚到最近一次复制完成后的完整业务数据，保证容灾中心业务数据的一致性，即生产业务可在容灾中心拉起，业务系统可以在容灾中心正常运行。：在哪种场景下，云容灾方案可支持一键式自动切换？：Oracle、SQLServer、DB2等大型数据库，一般建议采用物理机华为SAN存储方式部署，这种情况下，这些大型数据库可以一键式自动拉起切换。对于web应用主机，一般建议采用云主机的方式部署，拉起切换时需要登录华为云管理控制台启动相应的云主机，并确保应用可自动启动如设置计划任务或设置自启动服务：一键式自动切换后业务切换时间到底是多长？：业务切换时间和客户现网环境相关，主备容灾方案提供的一键式自动切换是将手动操作变为自动操作，减少人为操作时间，但是一些系统固定时间不能缩短，如主机应用启动时间、灾难切换的决策时间等。Oralce数据库切换的时间与数据库容量相关，通常时间为分钟级。：如何区分同步复制和异步复制的应用场景？：同步复制与异步复制最主要的区别在于RPO，即数据丢失量。基于同步复制的主备容灾解决方案，可以保证在生产中心系统出现灾难时，容灾中心存在一份与生产中心数据完全一致的数据副本具有完整的一致性，即可以实现零数据丢失。对于同步复制，生产中心必须等到数据成功的写到容灾中心，才能进行下一个I操作，同步复制对容灾链路的时延、距离有如下要求：容灾链路为FC链路，两个数据中心之间距离建议不超过100km。与同步复制相比，基于异步复制的主备容灾解决方案对带宽和距离的要求低很多，它只要求在某个时间段内能将数据全部复制到异地即可，同时异步复制的方式也不会明显影响应用系统的性能。其缺点是在本地生产数据发生灾难时，异地系统上的数据可能会短暂损失，但不影响异地系统的数据一致性。：客户自有的生产中心和华为云容灾中心之间带宽有限，使用容灾链路做初始同步太花时间，有没有其他更好的初始同步方案？若复制带宽不足，为快速完成初始数据同步，可采用以下几种方式：、临时增加复制带宽完成初始同步。、先将容灾中心的华为存储阵列搬到生产中心，在生产中心快速完成初始同步后，再将其搬迁到容灾中心。、通过移动介质存储中转进行初始同步。：容灾采用存储复制时，需要的带宽如何计算？如果采用同步复制，则要求链路带宽大于峰值业务写带宽。举例：某应用的峰值写带宽为10MB，平均写带宽为200KB，平均写IO大小为4KB；带宽利用率建议用60计算。网络带宽要求如果采用异步复制，则要求链路带宽大于平均业务写带宽。举例：某应用的峰值写带宽为10MB，平均写带宽为200KB，平均写IO大小为4KB；带宽利用率建议用60计算。网络带宽要求：远程复制时如果发生网络故障，网络恢复时，复制动作如何继续？：华为存储提供网络故障修复后，自动恢复复制的功能。：容灾管理软件对服务器的规格要求？：容灾管理软件支持云主机部署，标准配置规格为：4核8GB数据盘的云主机，操作系统选择WindowsServer2008R264位企业版。容灾管理软件所需要的建议带宽为10Mb
创建版本时无法导入模板怎么办？	当您的浏览器是IE9时，创建版本时可能无法使用导入模板功能，请参考如下步骤修改浏览器默认属性后重试。在浏览器主界面，单击点击放大选择选项单击选择安全页签。单击可选单击默认级别按钮。如果安全级别显示为自定义，请将设置还原为默认级别。滑动安全级别滑块，将安全级别调到级别。单击应用按钮。单击自定义级别对未标记为可安全执行脚本的ActiveX控件初始化并执行脚本设置为提示单击确定
我可以使用对象元数据做什么？	我可以使用对象元数据做什么？显示对象元数据我可以使用对象元数据做什么？我可以使用对象元数据做什么？元数据为描述对象的数据，主要是描述对象属性的信息。对象元数据是一组名称值对，用作对象管理的一部分。目前仅支持设置三种名称的系统定义的元数据。表1支持的三种名称的系统定义的元数据名称说明为请求的对象提供一个默认的文件名赋值给该对象，当下载对象或者访问对象时，以默认文件名命名的文件将直接在浏览器上显示或在访问时弹出文件下载对话框。例如：元数据名称选择为，元数据值填写为，当通过链接访问设置了该元数据的对象时，会直接弹出一个对象下载的对话框，且对象名称会被修改为指定对象内容显示的语言类型。例如：元数据名称选择为，元数据值填写为，当访问设置了该元数据的对象时，对象内容默认显示为英文。为对象提供重定向功能，重定向到其他对象或者外部的URL。重定向功能通过静态网站托管实现。例如：在桶属性静态网站托管页面将该桶中的的对象设置为静态网站托管的默认首页。再到对象管理页面将对象元数据名称选择为，元数据值填写为，当通过静态网站托管页面上的访问地址访问对象时，会直接重定向访问http
如何将云硬盘挂载给云服务器	管理控制台上，单击云硬盘所在行操作列下的挂载即可。
如何将DDS备份到弹性云服务器上	您可以通过mongodump和mongorestore的方式将数据库备份到ECS上。ECS不限制存放哪些数据，只要符合国家法律法规就行。您可以在ECS上存放数据库备份，但不建议将ECS作为数据库备份空间使用。强烈推荐使用实例的备份功能，将备份数据存放到专业的对象存储OBS上，以获得更高的数据可靠性和服务保障。
如何从云服务器访问文件系统？	要访问您的文件系统，您需要在Linux云服务器上使用挂载命令挂载文件系统。挂载完成后，可共享您的文件系统中的文件和目录。
哪些内容会占用用户所购买的RDS实例空间	用户正常的数据不包括备份数据，以及RDS实例正常运行所需的数据比如系统数据库、数据库回滚日志、重做日志、索引等。同时，包含如下RDS的必要日志文件：数据库产生的Binlog日志。数据库服务器产生的日志文件。数据库产生的日志文件日志、默认的Trace文件和代理日志文件等这些文件保证RDS实例正常稳定地运行。
告警状态有哪些？	目前云监控支持三种告警状态：告警、正常、数据不足。当告警规则被关闭时，告警状态为无效，界面显示为已停用数据不足指告警规则最近的一个监控周期内没有相应的指标数据，通常是由于相应服务实例被删除或状态异常导致的。
弹性负载均衡是什么？	弹性负载均衡，以下简称ELB通过将访问流量自动分发到多台弹性云服务器，扩展应用系统对外的服务能力，实现更高水平的应用程序容错性能。用户通过基于浏览器、统一化视图的云计算管理图形化界面，可以创建ELB，为服务配置需要监听的端口，配置云服务器。消除单点故障，提高整个系统的可用性。
针对管理控制台的异常提示信息，应该如何处理？	问题描述您可以通过本FAQ解决如下问题：用户在管理控制台执行弹性云服务器相关操作后出现异常，针对管理控制台提示的异常信息，应该如何处理？用户参见弹性云服务器接口参考调用云服务器相关的API接口时，如果返回错误码，应该如何处理？
产品优势	产品优势显示一般性问题产品优势产品优势对象存储服务具有如下优势：数据稳定，业务可靠：OBS支撑华为手机云相册，数亿用户访问，稳定可靠。通过AZ内设备和数据多冗余、AZ之间数据容灾，保障数据持久性高达99，业务连续性高达99，远高于传统架构。多重防护，授权管理：OBS通过可信云认证，让数据存储安全放心。并支持多版本、服务端加密、防盗链、VPC网络隔离、访问日志审计以及细粒度的权限控制，保障数据安全可信。智能高效，随需扩展：OBS通过智能调度和响应，优化数据访问路径，并结合事件通知、传输加速、大数据垂直优化，为用户提供大并发、大带宽、稳定时延的数据访问体验，为业务保驾护航。简单易用，便于管理：OBS支持标准RESTAPI、多版本SDK和数据迁移工具，让业务快速上云。无需事先规划存储容量，存储资源可线性无限扩展，不用担心存储资源扩容、减容问题。数据分层，按需使用：提供按量计费和包年包月两种支付方式，支持标准、低频访问、归档数据独立计量计费，降低存储成本。
裸金属服务器能否更换操作系统？	暂时不支持更换操作系统。
集群删除之后，相关数据能否再次找回？	集群删除之后，部署在集群上的应用也会同步删除，无法恢复，请慎重删除集群。
视频显示黑屏？	、D3D没有正常启用。按WIN运行框输入dxdiag，弹出诊断工具，点显示栏，查看DirectDraw是否正常启用。、显示模块出错，可以查看日志定位。显示不了自己视频查看日志CVideoEngine显示不了别人视频查看日志CVideoEngine、显示不了别人视频，没有接收别人数据。查看日志是否隔段时间会有日志CVideoCell、显示不了自己视频，设备被其它程序占用。运行AMCAP，找到设备，看是否能出现视频。
如何确认SSL根证书的有效期	如果您正在使用SSL连接MySQL，执行如下命令查看证书有效期起止时间，判断证书是否到期。在证书到期前请及时更新根证书为最新版本：下载新的根证书文件或根证书捆绑包。重启实例以使新的根证书生效。使用新的根证书文件或根证书捆绑包连接实例。
DIS有哪些特点和优势？	永久在线：DIS永久在线，可以进行实时数据处理。利用DIS，您可以在数据生成时连续收集数据，并对您的业务和运营关键信息及时作出反应。无限扩展：DIS数据通道的吞吐量每小时可从数MB扩展到数TB，PUT记录每秒钟可从数千次扩展到数百万。易于使用：您可以在几秒钟内创建DIS数据通道，轻松的将数据放入通道中，并构建用于数据处理的应用程序。成本低廉：DIS没有前期成本，您只需要为实际使用的资源付费即可。并行处理：DIS可让您用多个应用程序同时处理同一个数据通道。例如，您可以让一个应用程序运行实时分析，让其他应用程序从同一个DIS数据通道中将数据发送至OBS。安全可靠：DIS可将数据保留24小时或168小时，以防数据在应用程序故障、个别机器故障或设施故障时丢失。
如何获得来访者的真实IP？	针对7层协议服务，ELB通过HttpHeader获取来访者真实IP，该功能已经默认开启，无需配置，也不能修改。针对4层协议服务需要配置TOA插件获取。配置TOA插件请参考插件配置
如何导出监控数据？	用户在云监控页面选择实例监控，单击导出监控数据，根据界面提示选择服务维度监控对象指标，最后单击导出导出监控报告中第一行是指标数据采集时间，以Unix时间戳形式显示；第二行仍是指标数据采集时间，以ISO标准显示；第三行是指标数据值。如需要将Unix时间戳转换成时区时间，请按照如下步骤：用Excel打开csv文件。将时间戳利用如下公式进行换算。计算公式为：目标时间时间戳目标时区设置单元格格式为日期。例如，将时间戳1475918112000转化为北京时间，北京时间为时区，计算出的北京时间，将结果格式设置为日期，选择2016形式显示，转换成时间后为2016
OBS是否支持断点续传功能？	是否支持断点续传功能？显示桶和对象是否支持断点续传功能？是否支持断点续传功能？客户端支持断点续传功能，OBS管理控制台、API、SDK暂不支持该功能。
如何使用华为云提供的Ubuntu镜像源？	操作场景用户需要更新弹性云服务器的系统或者软件时，可以连接Internet，通过外部Ubuntu镜像源提供相关服务。但是，如果弹性云服务器无法访问Internet，或者外部Ubuntu镜像源提供的服务不稳定时，可以使用华为云提供的Ubuntu镜像源进行更新。
生产、测试环境如何使用？	测试环境用于用户进行调测，不对用户计费，测试环境对每一位用户有最大接入并发数的限制，目前为最高5个并发，即最多同时有5个客户端可以接入使用服务。生产环境会对用户进行计费，用户在测试环境调测完毕后，将接入地址改为生产环境即可。目前服务处于公测阶段，为保证公测用户的体验质量，会对每一位用户限制最大接入并发数500，公测阶段暂不收费。
什么是CCE？	云容器引擎是为开发者、合作伙伴提供开发、部署、托管的容器应用平台，帮助用户快速、低成本地实现业务创新，缩短应用上市周期。
如何使用MRS？	是公有云的一项基础服务，使用简单。通过使用在集群中连接在一起的多台计算机，您可以运行各种任务，处理或者存储巨量数据。MRS的基本使用流程如下：准备数据准备程序和数据文件，用户需要先将本地的程序和数据文件上传至对象存储服务中。创建集群使用MRS的首要操作就是购买集群，集群购买数量受弹性云服务器数量限制。配置集群基本信息，完成集群的创建。为节省您的宝贵时间，且方便使用MRS，创建集群时可同时提交作业。说明：创建集群时只能新增一个作业，若需要新增多个作业，则需要执行步骤
使用RDS可以运行多少个RDS实例	默认情况下，RDS允许每个租户最多可创建20个RDS实例。如果您的应用程序需要更多RDS实例，可以向客户经理或客服提需求，申请更多RDS实例。
订阅终端地址可以修改吗？	订阅终端地址不允许修改。如果需要更换某个主题下的订阅终端地址，可在消息通知服务中删除原有的订阅终端，重新在该主题下选择订阅协议并输入对应的订阅终端。
如何查看专属云中的云服务器？	专属云界面，单击我的资源区域内的弹性云服务器。如图1所示。图1专属云资源信息点击放大
从运营商拉专线该怎么发起？	目前，需要客户自行从运营商的官方服务渠道联系商务沟通。
我可以购买多少块云硬盘	您可以购买最多100块云硬盘。
在通过API直接调用的方式使用OBS过程中，密钥（AK和SK）是否可以更换？	在通过API直接调用的方式使用OBS过程中，密钥和SK是否可以更换？显示安全性在通过API直接调用的方式使用OBS过程中，密钥和SK是否可以更换？在通过API直接调用的方式使用OBS过程中，密钥和SK是否可以更换？可以，在使用过程中，密钥和SK可以随时更换。
DPS可以调度哪些服务？	可以调度以下服务：
主机入侵检测是否收费？	此项服务目前是免费提供给用户使用的。
支持与限制的命令	用户在连接到后，需要关注以下支持以及限制的命令。表1支持命令列表命令类别名称
我的数据存在OBS中，如何保证安全性？	我的数据存在OBS中，如何保证安全性？显示安全性我的数据存在OBS中，如何保证安全性？我的数据存在OBS中，如何保证安全性？本身是非常安全的。OBS本身也提供端到端的安全服务。访问桶或对象时，如果桶或对象未公开，只有桶或对象的拥有者才能够访问，访问时需要提供安全密钥。您还可以使用各种访问控制机制，例如桶策略和访问控制列表，选择性地向您的用户和用户组授予权限。传输数据时，OBS支持HTTPS协议；如果您需要更高安全性，可在上传前自行进行加密。
远程登录弹性云服务器时，对浏览器版本的要求？	用户采用远程登录方式访问弹性云服务器时，使用的浏览器应满足表1表1支持的浏览器版本浏览器版本及以上及以上及以上
DES可以用于哪些场景？	主要适用于以下几种场景：大数据原始数据迁移：基因、石油、气象、IOT等原始数据迁移到华为云对象存储服务。接收互换数据：如果您经常通过物理存储介质从业务伙伴那里接收内容，可以让他们将数据直接发送到华为云，以便导入对象存储服务。网站迁移：静态网站信息，图片，脚本，视频等静态资源迁移到对象存储服务中。离线备份数据：将完整备份或增量备份发送至华为云对象存储服务，实现可靠的冗余离站存储，可以和混合云备份方案配合使用。灾难恢复：如果有大量数据需进行容灾准备，初始同步可以采用线下传输服务，将具有更具性价比的传输。
什么是DNS验证？	验证，是指在域名注册平台通过解析指定的DNS记录，验证域名所有权。
产品发布了新版本后，已创建的产品实例可以自动更新版本吗？	产品实例创建后，不会自动更新版本，可以使用新版本重新创建实例。
碎片管理	显示碎片管理碎片管理
一台弹性云服务器可以挂载多块云硬盘吗？	可以，一台弹性云服务器最多挂载10块云硬盘作为数据盘。特别的，对于密集存储型弹性云服务器，最多可挂载27块数据盘包括云硬盘和本地盘
使用DES的流程是什么样的？	您在开通DES服务后，即可登录管理控制台创建服务单，将待邮寄数据按要求存放入待邮寄磁盘中后，即可将磁盘寄送至华为数据中心。当华为数据中心收到您邮寄的磁盘后，会将磁盘挂载至服务器并通知您尽快启动上传任务。此时您可再次登录管理控制台填写AK和加密密钥启动数据上传。数据传输完成后您还可以查看数据传输报表，确认无误后华为数据中心将回邮您的磁盘。
DDS在shard节点扩容期间服务是否可用	可用，的扩容操作是在实例中增加新的分片，原实例中的分片不变，不影响服务的可用性。
弹性云服务器的登录用户名是什么？	操作系统的用户名为root，Windows操作系统的用户名为Administrator。密码为用户创建弹性云服务器时设置的密码。
什么是分区？	分区是DIS数据通道的基本吞吐量单位，每个Partition提供1MB秒数据输入和2MB秒数据输出容量。一个分区最高可支持每秒1000个PUT记录。创建通道时，将指定所需的分区数量。目前每个租户默认Partition配额范围为1个，租户可以根据需要配置Partition个数。
为什么对decimal数据类型进行带过滤条件的查询时会出现异常输出？	当对decimal数据类型进行带过滤条件的查询时，输出结果不正确。例如：输出结果：|name|num||IAA|1234567890123456||IAA|1234567890123456解决方法：为了得到准确的输出结果，需在数字后面加上例如：输出结果：|name|num||IAA|1234567890123456
软件开发云各服务如何收费？	背景信息软件开发云支持基础按需计费基础套餐按需计费两种。如果开通了基础套餐，则优先按基础套餐计费，计费方式分别如下：
FunctionStage是什么？	是华为云提供的serverless服务，用户无需预配置服务器等基础设施，实现上传代码即可运行。FunctionStage在执行代码时实现计算资源自动伸缩，以弹性和高可靠性运行代码，并提供日志查询，性能监控等功能。用户借助FunctionStage可以快速构建起多种类型的应用和服务。用户无需管理和运维，由FunctionStage承担执行计算资源的管理工作，如服务器和操作系统维护、容量预置和自动扩展、代码监控和记录等。用户只需为运行代码消耗的计算资源支付费用，代码未运行时不产生费用。
云服务器创建私有镜像的时候一定要关机吗？	是的。运行状态下的云服务器，其内存可能会缓存正准备写入的数据，为了避免您制作的镜像出现数据丢失问题，请您在制作镜像前关闭云服务器。
通过puttygen.exe工具创建的密钥对，导入管理控制台失败怎么办？	工具创建的密钥对，导入管理控制台失败怎么办？问题描述通过puttygen工具创建的密钥对，在导入管理控制台使用时，系统提示导入公钥文件失败。
DIS如何发送和接收数据？	开通DIS通道，在IAM用户认证中心中获取账号的AK进入，获取并解压DIS的SDKJar包和样例工程。建立工程，配置用户AK、通道名称、分区数量等。配置完成后运行程序即可发送数据。建立工程，配置用户AK、通道名称和分区数量。配置完成后运行程序即可接收数据。
弹性云服务器能否更换操作系统？	能。更换方法请参见切换弹性云服务器的操作系统
如果删除我的云帐号是否会删除备份	一旦删除云帐号，备份数据也随之删除。
如何开始使用UQuery	使用UQuery查询数据基本流程如下：登录UQuery创建数据库创建数据表查询数据查看结果详细操作步骤，请参见用户指南快速开始：如何查询数据章节。
弹性云服务器可以做什么？	弹性云服务器与传统硬件服务器一样，可以部署任意业务应用，例如：邮件系统、WEB系统、ERP系统等。
使用DES是否必须同时开通OBS服务？	是的。这是由于使用DES服务传输的数据要存储在OBS服务中，所以您必须开通OBS服务。
能创建和使用多少个产品组合、产品和产品实例？	您默认可以创建25个产品组合，25个产品，200个产品实例。每个产品可以创建50个版本，每个产品组合可以创建25个约束。如果系统提供的默认配额不能满足您的需求，请联系管理员进行处理。
按需付费的弹性云服务器如何变更规格？	您可以随时变更您的弹性云服务器规格，由于是按需计费，所以您不需要补齐差额，只要保证您帐户上的余额大于余额受限阈值即可。变更前先关机，之后再启动弹性云服务器即可变更成功。
DES和普通网络传输数据相比有什么优势？	和普通的网络传输相比，DES有很多优势：更高效快速的传输用户直接将磁盘邮寄到数据中心，数据中心将磁盘手动挂载到存储设备上，然后通过内部网络进行高速数据传输，传输速度可达Internet传输速度的10倍，大大提高了数据传输速率，节省时间。数据更安全支持使用第三方Truecrypt工具进行数据加密后再邮寄，可确保在寄送磁盘途中的数据安全。华为数据中心管理员将磁盘挂载到物理服务器后，由用户上传AK、加密密钥触发数据传输。华为人员全程不接触客户密钥及客户数据，确保数据在传输过程中的安全。数据最终存储在对象存储服务中，OBS服务具有强大的安全保障机制，支持SSL加密、ACL、桶策略、数据分片存储等。成本低、经济实惠按量收费，数据传输成本可低至使用高速Internet费用的五分之一。零维护成本，无需专人维护。
OBS会不会扫描我的数据用于其他用途？	会不会扫描我的数据用于其他用途？显示安全性会不会扫描我的数据用于其他用途？会不会扫描我的数据用于其他用途？系统对数据做的扫描仅限于判断数据块是否存在和被损坏如有损坏，会启动修复，不会读取具体的内容。
如果域名已经被使用，怎么办？	创建域名提示域名已经被其他帐号创建，说明该域名已经在华为云上被其他用户创建过了。如果您是域名的所有者，请在工单管理系统中提交工单，申请找回域名。提交的工单中需包括以下信息：域名购买凭证购买域名成功的邮件域名所有者证明等
怎么扩容数据盘	扩容云硬盘的整体流程如下所示：卸载云硬盘：将云硬盘从挂载的云服务器卸载下来。扩容云硬盘：根据您的使用需求对云硬盘进行扩容。挂载云硬盘：将扩容后的云硬盘挂载至云服务器初始化云硬盘：登录云服务器对云硬盘新增部分进行初始化。初始化成功后，扩容后的云硬盘便可正常使用。
Git客户端如何使用？	使用Git客户端前，需要了解Git安装、创建新仓库、检出仓库、工作流、添加与提交、推送改动、创建分支、更新与合并分支、创建标签、替换本地改动等基本操作。基本操作流程客户端基本操作流程如图1所示。图1客户端基本操作流程
如何对OBS上的数据进行访问控制？	如何对OBS上的数据进行访问控制？显示安全性如何对OBS上的数据进行访问控制？如何对OBS上的数据进行访问控制？您可以使用以下几种机制来控制对OBS的访问：访问密钥和SK身份验证向您提供的帐户包括了AK接入键标识，AccessKeyID和SK安全接入键，SecretAccessKey，用于鉴别身份。您通过客户端向OBS发送请求时，客户端发送的头域需要包含签名信息，该签名信息由SK、请求时间、请求类型等计算生成。访问控制列表可以限制所有用户或特定用户对单个桶或对象的访问权限，例如只读权限，写入权限，完全控制权限。所有的桶和对象在默认情况下，只允许桶的创建者访问桶内的对象。用户也可以设置其他的访问策略，比如对一个对象可以设置公开访问策略，允许所有人对其都有读权限。OBS支持在创建桶或上传对象时可以同时设置桶或对象的权限控制策略。如果在创建桶或上传对象时没有设置权限控制策略，则可以在之后的操作中对已存在的桶或对象，使用ACL操作获取或更改ACL。ACL只能用来授予权限。桶策略通过桶策略，您可以定义OBS资源请求的规则，以控制单个用户或多个用户访问桶或桶下对象的访问权限。例如在某些请求条件下例如请求来自某个IP或IP段，授予对某个桶的写入权限。桶策略既可以用来授予权限，也可以禁止权限。
如何使用编译构建？	编译构建与代码托管无缝对接，提供云端编译构建，支持一键创建、配置和执行，实现获取代码、构建、打包等活动自动化，实时监控构建状态。
如何进行分片	在分布式数据库中，可以通过分库分表存储方式，轻松解决大数据量单表容量达到单机数据库存储上线的瓶颈。但是分库存储后，需要尽量避免跨库JOIN操作带来的性能与资源消耗问题。因此创建逻辑库和逻辑表时，需要根据实际情况确定：逻辑表分不分片。逻辑表支持全局表、分片表、单表三种类型。用户可以按照数据表的实际使用需求，选择最合适的逻辑表类型创建。单表只在第一个逻辑库中创建表以及存储数据；全局表在每一个分库上创建表并且存储全量数据；分片表在每一个分库上创建表，数据按照拆分规则分散存储在分库中。按什么规则分逻辑表的拆分键选择非常重要。建议按实际业务场景选择拆分键，不同逻辑表，如果具有E关系，建议选择相同字段做拆分键，避免跨库JOIN操作。
如何修复虚拟化驱动异常的弹性云服务器？	问题背景华为云运维人员在对云平台做例行健康检查时，发现用户的部分弹性云服务器虚拟化驱动异常没有正常运行。为保证弹性云服务器的正常使用，请用户参见本节内容进行修复。
占用DDS磁盘空间的日志及文件有哪些	占用磁盘空间的日志及文件如下表：数据库类型文件类型日志文件：日志文件。数据文件：数据库内容文件，索引文件。其他文件：一些临时文件。
如何购买旧版软件开发云套餐？	背景信息软件开发云为用户提供了两种不同规格的旧版套餐人套餐人套餐，用户可以根据需要进行购买。软件开发云旧版套餐中，包含的服务如下：项目管理配置管理编译构建代码检查测试管理发布管理
如何保证数据和业务运行安全？	作为一个海量数据管理和分析平台，具备高安全性。主要从以下几个方面保障数据和业务运行安全：网络隔离整个公有云网络划分为2个平面，即业务平面和管理平面。两个平面采用物理隔离的方式进行部署，保证业务、管理各自网络的安全性。业务平面：主要是集群组件运行的网络平面，支持为用户提供业务通道，对外提供数据存取、任务提交及计算能力。管理平面：主要是公有云管理控制台，用于购买和管理MRS。主机安全用户可以根据自己业务的需要部署第三方的防病毒软件。针对操作系统和端口部分，MRS提供如下安全措施：操作系统内核安全加固更新操作系统最新补丁操作系统权限控制操作系统端口管理操作系统协议与端口防攻击数据安全支持数据存储在OBS上，保障客户数据安全。数据完整性处理完数据后，通过SSL加密传输数据至OBS，保证客户数据的完整性。
在一个RDS实例内能运行多少个数据库	没有强制限制，取决于数据库引擎自身设置。最多可创建1000个数据库、1000个数据库帐号。可创建无限个数据库、无限个数据库帐号。可创建30个数据库、无限个数据库帐号。
如何查看作业输出结果？	支持将作业的结果数据输出到DIS上，因此用户需要到DIS上去查看输出结果，详细操作请参见DIS的操作指南也支持将作业的结果数据输出到RDS上，因此用户需要到RDS上去查看输出结果，详细操作请参见RDS的用户指南快速入门
如何取消消息接收？	可以在指定接收组中取消勾选的主题。
当前专线接入点有哪些？	您可以提交工单获得最新的接入点信息。
如何选择设备节点和个数？	您可以根据您的应用软件所占用的计算资源进行整体汇总，并按照每个设备节点可提供的计算资源进行估算，得出对应设备节点的个数。
什么是裸金属服务器?	裸金属服务器提供单租户专属的物理服务器，通过卓越的计算性能，满足核心应用场景对高性能及稳定性的需求，同时可以和VPC等其他云产品灵活结合使用，结合了传统托管主机带来的稳定性能与云上资源高度弹性的优势。裸金属服务器的开通是自助完成的，您只需要指定具体的服务器类型、镜像、所需要的网络配置，我们将会在最短的时间内帮您开通。
OBS是否支持批量上传？	是否支持批量上传？显示桶和对象是否支持批量上传？是否支持批量上传？客户端、API、SDK均支持批量上传，而OBS管理控制台暂不支持批量上传。通过OBS客户端、API、SDK，您不仅可以批量一次上传多个文件，也可以一次性上传整个文件夹。
什么是用户最大并发数？	该并发数会限制用户接入服务生产环境的最高并发数，目前服务处于公测阶段，为保证公测用户的体验质量，会对每一位用户限制最大接入并发数500。
如何使用移动应用测试？	移动应用测试提供移动兼容性测试服务，只需提供移动应用安装文件并选定测试覆盖机型，即可自动完成深度遍历测试和特性分析，检测问题并监控性能指标，生成包含图片和日志的详细报告，帮助定位和快速分析问题。
如何解决堆栈无法删除的问题？	问题描述删除堆栈时，堆栈状态一直显示为删除中，最后提示超时。堆栈状态显示异常，操作状态为卸载失败，再次删除依然失败。查看堆栈执行日志，出现相关字段。
静态网站托管	显示静态网站托管静态网站托管
如何通过JDBC连接PostgreSQL数据库	通过JDBC连接实例的方式有无需下载SSL证书连接和用户下载SSL证书连接两种，其中使用SSL证书连接通过了加密功能，具有更高的安全性。前提条件用户熟悉计算机基础知识，了解java编程语言，了解JDBC基础知识。
云监控支持的聚合方法有哪些？	云监控支持的聚合方法有以下五种：平均值聚合周期内指标数据的平均值。最大值聚合周期内指标数据的最大值。最小值聚合周期内指标数据的最小值。求和值聚合周期内指标数据的求和值。方差聚合周期内指标数据的方差。说明：聚合运算的过程是将一个聚合周期范围内的数据点根据相应的聚合算法聚合到周期起始边界上，以5分钟聚合周期为例：假设当前时间点为10，则10之间的原始数据会被聚合到10这个时间点。
为什么很多访问ELB实例的后端云服务器IP是100.125开头的？	开头的？这是由于ELB系统进行健康检查引起的。系统除了会通过系统服务器的内网IP将来自外部的访问请求转到后端云服务器上之外，还会对云服务器进行健康检查，并对后端服务进行可用性监控，这些访问的来源都是由ELB系统发起的，具体包含的IP地址段是：100为了确保您对外服务的可用性，请确保在云服务器所在的安全组上对上述地址的访问配置放行规则。
事件	显示事件事件
什么是OBS？	什么是OBS？显示一般性问题什么是OBS？什么是OBS？对象存储服务，ObjectStorageService是一个基于对象的海量存储服务，为客户提供海量、安全、高可靠、低成本的数据存储能力，包括：创建、修改、删除桶，上传、下载、删除对象等。
裸金属服务器操作系统是否有图形界面？	当前提供的Linux操作系统是命令行界面，用户如果需要可以自己设置图形管理。
CCE服务如何定价？	使用CCE服务不收取任何额外费用。您只需为您使用的用于计算，存储和网络的资源付费。
结束会议为什么会莫名crash掉？	入可能是因为客户端在调用离会或者结束会议的接口后立即调用tup接口导致。解决方法为调用离开会议或结束会议后，再抛一个消息异步调用tup接口释放会议对象。
什么是TOSCA模板？	是开放标准联盟OASIS管理的独立技术委员会之一，其发布的云应用拓扑及编排描述规范简称TOSCA规范目标是规范多厂商云应用生命周期管理流程。ServiceStage应用拓扑模型如图1所示。图1应用拓扑模型点击放大
数据超过了RDS实例的最大存储容量怎么办	如果您的应用程序所需的存储容量超过最大分配量，解决措施如下：扩容存储空间暂不支持分库分表。
什么是对象元数据？	什么是对象元数据？显示对象元数据什么是对象元数据？什么是对象元数据？元数据为描述对象的数据，主要是描述对象属性的信息。对象元数据是一组名称值对，用作对象管理的一部分。
一块云硬盘可以挂载到多个云服务器上吗	不可以，一块云硬盘同时只能挂载到一台云服务器上。当云硬盘为共享盘时，支持同时挂载最多16个云服务器说明：共享盘是云硬盘的一种，可以同时挂载到多个云服务器。
什么是华为云会议？	华为云会议华为云会议提供移动、PC、专业会议室终端一致体验，助您完成跨区域、跨企业、跨组织的沟通与协作，打破企业壁垒，实现与商业伙伴、客户的全面联接。
DDS支持哪些存储引擎	目前只支持WiredTiger存储引擎。
文件系统数据如何保存？	文件系统的数据使用ErasureCode纠错码方式存储数据，保障数据安全。
如何甄别数据库中数据被损坏	数据被篡改有很多安全措施保证只有经过认证的用户才能操作数据库表数据。另外SSH协议对外不可访问。只能通过指定的数据库服务端口来访问数据库表。主备数据库在同步过程中有传输包校验功能，所以不会出现数据被篡改。MySQL使用InnoDB引擎，不容易出现数据损坏。可能会出现实例服务器突然停电，导致数据库有页损坏，数据库无法启动。这时候RDS会故障切换进行服务。
如何查看集群配置信息？	集群创建完成后可在基本信息页面中查看集群的基本配置信息，包括集群的名称、ID、付费类型、工作地域、创建时间、Hadoop组件版本及节点的实例规格、容量。其中，节点的实例规格和容量决定了该集群对数据的分析处理能力。节点实例规格越高，容量越大，集群运行速度越快，分析处理能力越强，相应的成本也越高。基本信息页面，单击，跳转至MRS集群管理页面。用户可在集群管理页面查看和处理告警信息、修改集群配置以及升级集群补丁等。
DES服务单创建后我还能取消么？	可以。当服务单的状态为待寄送磁盘时可取消服务单。
云专线端口类型有哪些?	云专线按端口类型分为1GE和10GE。
如何一键购买软件开发云套餐？	背景信息软件开发云为用户提供了两种不同的套餐包，如表1所示。表1套餐包介绍套餐包套餐介绍基础套餐软件开发云基础套餐，每月按需、按人头数、先使用后付费。每个人头包含一定量的使用额度，超出额度另外计费。用户可以根据需要进行购买，基础套餐包含的服务如下：项目管理配置管理编译构建代码检查测试管理发布管理流水线部署管理政府套餐政府套餐的套餐规格如下：青岛10人套餐青岛50人套餐大连10人套餐大连20人套餐用户可以根据需要进行购买，政府套餐包含的服务如下：项目管理配置管理编译构建代码检查测试管理发布管理弹性云服务器弹性IP
如何处理状态是“异常[已删除]”的后端云服务器？	异常已删除的后端云服务器？当后端云服务器的状态为异常且出现标记已删除，则表示该云服务器已在云服务器服务中删除。为更好的管理后端云服务器、减少冗余资源，防止分发异常，请对该后端云服务器进行移除操作。图1后端云服务器状态点击放大
使用FunctionStage开发能否引入类库？	对于Node和Python运行时，支持用户在线编辑函数。在线编辑，只能实现比较简单的功能，不能引入标准及第三方类库。由于Java是编译型语言，所以不能在线编辑代码，只能上传jar包或者zip包，zip包中也必须是编译好的jar包。如果开发一个逻辑相对复杂函数，可以在本地编码，构建打包包含标准及第三方类库，上传至FunctionStage即可运行。
如何使用代码广场？	背景信息代码广场是面向所有用户的统一公开代码仓库的展示平台，用户登录软件开发云后直接可见。支持在云端查看公开代码仓库，还可以搜索、推荐公开代码仓库以及对代码仓库进行克隆、关注、评价等。
已删除的数据在OBS中是否会有残留？	已删除的数据在OBS中是否会有残留？显示安全性已删除的数据在OBS中是否会有残留？已删除的数据在OBS中是否会有残留？用户选择清除数据之后，系统会保证完全删除数据，不会留下残留信息，无需担心信息泄露。
什么是聚合方式？	聚合方式是视图中日期型维度或数值型度量聚合展示的规则。云报表服务所有视图均支持聚合方式展示。使用方法：绘制视图时，用户可以在数据列参数区域下，选择维度或度量所在行，单击聚合方式，根据需要选择具体的聚合方式，例如计数。
如何获取证书？	用户可以在证书管理界面申请证书或直接下载已签发的证书，步骤如下：登录管理控制台。选择安全证书管理服务，进入申请证书列表界面。单击界面左上角的申请证书目前证书管理服务平台只支持申请一种证书，即免费版的DVSSL证书，一个证书只能绑定一个域名，如图1所示。图1申请证书点击放大
哪些参数设置不合理会导致数据库不可用（PostgreSQL）	由于参数配置不合理导致数据库不可用的情况有以下几种。参数取值范围和实例规格有关：参数shared、max可配置的最大值和实例的实际物理内存大小有关，设置不合理，会导致数据库不可用。参数之间存在关联关系：如果参数log、log或log存在配置为开启的情况，则需要将参数log配置为关闭，否则会导致数据库不可用。参数max、autovacuum和max配置需满足以下规则，否则会导致数据库不可用。参数值参数值参数值说明：各参数的详细说明请参见官网
我如何才能知道DES服务单的状态进展？	您可以登录DESConsole，单击服务单号前的箭头图标查看该服务单详情。另外，当服务单申请成功、磁盘挂载成功、数据传输成功和订单关闭时，DES还会短信通知您，让您掌握DES服务单关键进展。
我的实例是否会受其他用户实例影响	实例不会受其他用户实例影响，因为每个用户的文档与其他用户的实例是独立的，并且有资源隔离，互不影响。
为什么事件列表中有些事件的资源ID为超链接可以跳转，有些为非超链接？	目前CTS仅支持部分ECS、EVS、VBS、IMS、AS、CES和VPC的操作通过资源ID跳转到对应云资源的详情页面，该功能正在逐步完善。
分布式缓存服务支持公网访问吗？	不支持。您必须通过同一虚拟私有云下的弹性云服务器来访问缓存实例。
如何安装MySQL客户端	官网提供了针对不同操作系统的客户端安装包，以5为例。单击此处下载5的最新版本，单击此处下载其他归档版本。下面将以RedHatLinux为例介绍如何获取相应安装包及完成安装。操作步骤获取安装包。在下载页面找到对应版本链接，以MySQL为例，打开页面后，即可下载安装包。图1下载点击放大
什么是DDS连接数	数据库连接数表示应用程序可以同时连接数据库的数量，一般指客户端同mongos之间的连接数。与您应用程序或者网站能够支持的最大用户数没有关系。
如果用户已开通云审计服务，但OBS桶未配置正确的策略，会出现什么情况？	云审计服务会根据既有的OBS存储桶策略来传送事件文件。如果错误地配置OBS存储桶策略，那么云审计服务将无法传送事件文件。被删除或有异常的OBS桶，管理控制台界面会显示相应的错误提示信息。用户可选择重新创建OBS桶或重新配置OBS桶的访问权限，操作详情请参见对象存储服务用户指南桶管理章节。
私有镜像占用的存储空间是否需要收费？	私有镜像占用的对象存储空间，后续会按照存储容量按需收费。当前阶段是试用阶段，您可以免费使用。
在已有的节点创建应用时未重新拉取镜像？	当容器镜像的tag不是latest时，用户更新该容器镜像但没有更改镜像的tag，则使用该镜像创建应用时，就不会重新拉取更新后的镜像，需要您在更新镜像的同时更改镜像的版本tag。
M	语句？将数据源集成到Spark生态系统，是Spark的一部分，所以不止可以提交M语句，还支持所有可以直接在SparkSQL上运行的SQL查询操作。
如何查看所有集群？	所有的集群都展示在集群列表页面中，进入集群列表页面，可查看所有集群。集群数量较多时，可采用翻页显示，您可以查看任何状态下的集群。现有集群：包含除已终止状态外的所有集群。历史集群：仅包含已终止状态的集群，目前界面只显示6个月内创建且已终止的集群，若需要查看6个月以前创建的集群，请联系技术支持人员。任务状态：仅包含失败状态的任务。在任务状态页面，您还可以删除失败的任务。集群创建失败的任务集群终止失败的任务集群扩容失败的任务
是否支持帐户余额变动提醒？	系统会以邮件、短信形式给客户发送账户余额变动通知，包括账户余额调整、充值到账、客户在线充值等。
服务单状态是“待寄送磁盘”是什么意思？	待寄送磁盘是什么意思？当DES服务单已完成创建后，服务单状态将变为待寄送磁盘。此时您需要准备待传输的数据存放入磁盘中并将磁盘寄出。若您已经寄出磁盘，请耐心等待，当华为数据中心接收到磁盘，管理员将磁盘挂载完成后，服务单状态将发生改变。
专属云内云服务器如何计费？	专属云内支持按需购买云服务器，计算资源不计费，使用用户已申请的设备节点剩余的计算资源。云服务器内云硬盘及弹性IP按需计费。按需购买云服务器时，云硬盘及弹性IP等的按需费用会比包周期的费用偏高，如果您长期使用云服务器，建议您先在云硬盘及VPC处包周期购买云硬盘及弹性IP，再根据需要将云硬盘及弹性IP绑定在按需创建的云服务器上。
SOA记录中的Email格式为什么变化了？	用户在创建域名时输入的Email，是域名管理员的邮箱，用于接收该域名的错误信息和问题报告。您可以使用常用的邮箱地址作为管理员邮箱，但是，RFC2142强烈建议您优先使用保留邮箱域名作为该域名的管理员邮箱。域名创建完成后，Email信息会自动记录在该域名的SOA记录中。但是，由于符号在SOA记录中有特殊的含义，因此邮箱地址中的符号会被替换为符号，同时，如果符号前面有符号，系统会自动使用转义字符进行转换。更多详情，请参见RFC1035。示例：为例。假设用户在创建域名时输入的Email为，那么，域名创建完成后，SOA记录中呈现的Email为
怎样停止计费？	对于采用按需付费计费方式的产品，包括按需付费的弹性云服务器、按需付费的云硬盘等，如果用户不再使用该产品，需彻底停止计费，请直接删除相应产品。对于采用包年包月计费方式的产品，包括包年包月的弹性云服务器、包年包月的云硬盘等，用户在购买时一次性付费，到期自动停止使用。如果用户提前终止使用，系统不会予以退费。以按需付费的弹性云服务器为例，详细介绍删除弹性云服务器对计费的影响。假设该云服务器的组成如表1所示。表1按需付费的弹性云服务器样例弹性云服务器的组成说明计费方式弹性云服务器基础资源包括vCPU、内存、镜像按需付费云硬盘系统盘按需付费数据盘按需付费弹性IP按需付费
每个用户可以创建多少个主题？	每个用户可以最多创建3000个主题。
哪些情景需要上云迁移？	通常，有如下情景需要提供业务迁移服务：原业务平台即将过保或已过保，拟采购华为虚拟化平台的情景。原业务平台空间已无法再次扩容，通过购买华为虚拟化平台提供更大容量空间的情景。原业务平台性能已不能满足业务需要，购买华为虚拟化平台来提升性能的场景数据中心虚拟化资源池建设，需要对整体架构重新设计时。
Hive与其他组件有什么关系？	与HDFS间的关系是Apache的Hadoop项目的子项目，Hive利用HDFS作为其文件存储系统。Hive通过解析和计算处理结构化的数据，HadoopHDFS则为Hive提供了高可靠性的底层存储支持。Hive数据库中的所有数据文件都可以存储在HadoopHDFS文件系统上，Hive所有的数据操作也都是通过HadoopHDFS接口进行。与MapReduce间的关系所有的数据计算都依赖于MapReduce。MapReduce也是Apache的Hadoop项目的子项目，它是一个基于HadoopHDFS分布式并行计算框架。Hive进行数据分析时，会将用户提交的HiveQL语句解析成相应的MapReduce任务并提交MapReduce执行。与DBService间的关系的MetaStore元数据服务处理Hive的数据库、表、分区等的结构和属性信息，这些信息需要存放在一个关系型数据库中，由MetaStore维护和处理。在MRS中，这个关系型数据库由DBService组件维护。与Spark间的关系的数据计算也可以运行在Spark上。Spark也是Apache的一个项目，它是基于内存的分布式计算框架。Hive进行数据分析时，会将用户提交的HiveQL语句解析成相应的Spark任务并提交Spark执行。
Windows弹性云服务器无法激活怎么办？	问题描述用户新购买的Windows弹性云服务器一般在1个小时内会自动激活，如果1个小时后仍然没有自动激活，则需要手动处理。
如何解决SR	场景下win7云服务器安装82599网卡驱动报错？问题描述从Intel官网下载最新的20版本驱动包下载地址：，该版本驱动包在Windows764位SR直通弹性云服务器上安装时会提示找不到英特尔适配器错误。
Windows操作系统制作私有镜像为什么要执行Sysprep操作？	对于需要加入域且使用域账号登录Windows操作系统的用户，在创建私有镜像前，需要执行Sysprep操作。否则，镜像会包含和原云服务器相关的信息，特别是SID信息。具有多个相同SID的云服务器加入域会失败。Sysprep的相关详细信息请参考：如果您的windows系统不需要加入域等操作，您可以选择不执行Sysprep操作。由于操作系统的相关限制，只能将Sysprep用于配置Windows操作系统的全新安装。可以根据需要多次运行Sysprep以构建和配置Windows安装。但是，重置Windows激活次数最多为三次。禁止使用Sysprep来重新配置已部署的Windows现有安装。在Windows命令行中输入以下命令，在弹出窗中查看还能执行Sysprep的次数。剩余Windows重置计数的值为0时，无法执行Sysprep。
我如何确定将数据存储在哪个区域？	我如何确定将数据存储在哪个区域？显示一般性问题我如何确定将数据存储在哪个区域？我如何确定将数据存储在哪个区域？根据您的个人需求不同需要考虑多个因素。您可能希望将数据存储在具备以下条件的区域：距离您的客户、数据中心或其他OBS资源较近，以便缩短数据访问延迟。距离运营地点很远，以实现地理位置冗余和灾难恢复。让您能够达到特定法律和法规要求。
为什么缓存实例创建后实际可用内存比申请规格小而且已使用内存不为0？	由于系统开销会占用部分资源，主备实例的持久化也需要一部分资源，所以实例创建后，实际可用内存小于申请规格。除了用户存储数据外，Redis内部的buffer以及内部数据结构会占用一部分内存。所以缓存实例创建后，实例已使用内存量不为0。
按照伸缩策略增加的云服务器，当我不用时可以自动删除吗？	可以，但是需要您增加一条删除云服务器的伸缩策略。
无法导入密钥对，怎么办？	当您的浏览器是IE9时，可能无法导入密钥对或无法使用文件注入功能，请参考如下步骤修改浏览器默认属性后重试。在浏览器主界面，单击选择选项单击选择安全页签。单击如果安全级别显示为自定义，单击默认级别按钮，把设置还原为默认级别。滑动安全级别滑块，把安全级别调到级别，单击应用按钮。选择自定义级别对未标记为可安全执行脚本的ActiveX控件初始化并执行脚本设置为提示单击确定
如何处理VNC方式登录弹性云服务器后，查看数据失败，VNC无法正常使用？	使用VNC方式登录弹性云服务器后，执行查看数据操作时，例如在Linux操作系统下使用cat命令查看大文件、播放视频，由于部分浏览器自身内存占用太大，导致VNC无法正常使用，请更换其他浏览器后重新登录弹性云服务器。
什么是聚合？	聚合是指云监控服务在一定周期内对原始采样指标数据进行最大、最小、平均、求和或方差值的计算，并把结果持久化的过程。这个计算周期又叫聚合周期。聚合是一个平滑的计算过程，聚合周期越长、平滑处理越多，聚合后的数据对趋势的预测和统计越准确；聚合周期越短，聚合后的数据对告警越准确。云监控服务的聚合周期目前最小是5分钟，同时还有20分钟、1小时、4小时、1天，共5种聚合周期。聚合过程中对不同数据类型的处理是有差异的。如果输入的数据类型是整数，系统会对数据进行取整处理。如果输入的数据类型是小数浮点数，系统会保留数据的小数点后两位。例如，弹性伸缩中实例数的数据类型为整数。因此，如果聚合周期是5分钟，采样指标数据分别是1和4，则聚合后的平均值为，而不是2用户可以根据聚合的规律和特点，选择使用云监控服务的方式、以满足自己的业务需求。
弹性云服务器密码设置简单会不会被入侵？	建议您的密码由数字、大小写字母、特殊符号组成，长度在8至26位。同时建议您从华为云的云市场中下载并安装虚拟化杀毒产品和主机安全加固产品，这样可以保证您的弹性云服务器受到更加全面的保护。
磁盘签名文件包含了哪些信息？	磁盘签名文件中包含的内容如下表所示：参数说明数据快递服务服务单号。可通过服务号在数据快递服务页面查询服务单状态。磁盘寄送目的地，即华为数据中心。数据中心详细地址。数据中心联系人。数据中心联系人电话。磁盘回邮详细地址。磁盘联系人。磁盘联系人电话。服务单创建时间。
LOADDATA如何指定HDFS路径?	当数据源导入到HDFS上之后，可以使用LOADDATA命令加载数据，此时路径必须以开头。比如在HDFS上有如下文件：点击放大那么在加载数据时，其HDFS路径为，M命令示例为：
单个主题是否支持通过多种传输协议进行订阅？	单个主题支持多种传输协议定义，目前支持HTTP、邮件、Functionstage以及短信传输协议。
为什么使用密钥文件无法正常登录Linux弹性云服务器？	问题描述用户使用创建弹性云服务器时使用的密钥文件登录Linux云服务器时，登录失败。
文件系统使用空间不足，可以扩容吗？	公测阶段，弹性文件服务不支持扩容功能。
DDS存储的存储配置是什么	存储采用EVS，具体情况请参考云硬盘用户指南的备份数据存储采用OBS，不占用用户购买的数据库空间。关于实例存储的硬件配置，请参见对象存储服务用户指南
操作系统是否有图形界面？	操作系统是桌面管理，Linux操作系统是命令行，用户如果需要可以自己设置图形管理。
私网弹性负载均衡适合什么使用场景？	在一个架构完整的系统中，通常包含多个子系统或者部件。通常各个子系统之间的访问是在内部网络中完成的。例如，业务服务节点对数据库节点的访问和各个子系统或者部件间的接口调用。私网弹性负载均衡可以为这些场景提供流量分发、横向扩展和容错等高可用性的功能。
OBS是否支持批量删除一个桶内的多个对象？	是否支持批量删除一个桶内的多个对象？显示桶和对象是否支持批量删除一个桶内的多个对象？是否支持批量删除一个桶内的多个对象？支持批量删除对象，一次批量删除的对象数最多为100个。OBS管理控制台和OBS客户端均支持批量删除多个对象。
Linux弹性云服务器怎样升级内核？	升级须知对于已安装Tools的Linux弹性云服务器，升级内核前，需先卸载Tools，否则存在如下风险：升级内核后，Linux弹性云服务器无法识别网卡，从而导致网络不通。升级内核后，Linux弹性云服务器无法识别数据盘，从而导致系统启动挂载点异常，弹性云服务器无法正常启动。
部署管理如何收费？	部署服务默认开通，且免费使用。用户部署的应用所使用的资源和部署依赖的服务所使用的资源、ReleaseMan存储、流量等由所使用的服务收费。
如何安装SQLServerManagementStudio	官网提供了SQLServerManagementStudio的安装包。SQLServerManagementStudio应用程序只能在Windows环境运行。操作步骤获取SQLServerManagementStudio的安装包。请访问网站，下载SQLServerManagementStudio。将安装包上传到ECS。双击安装包，按照向导完成安装。
云报表服务支持哪些数据源？	云报表服务目前支持数据源仅为MySQL数据库。
什么是DataPipelineService?	华为云的一项基础服务，可以帮助用户轻松地创建和调度数据管道任务。DataPipelineService集成了多种华为云基础服务，可以帮助用户轻松地使用和移动存放在OBS和RDS中的数据。DataPipelineService也可以帮助用户轻松地创建和调度基于华为弹性大数据服务的数据处理和分析任务。
为什么事件列表中的某些操作被记录了两次？	对于异步调用事件，会产生两条事件记录，其事件名称、资源类型、资源名称等字段相同。在事件列表中，看起来是重复记录了操作例如，Workspace的deleteDesktop事件，但实际上，这两条事件是相互关联、但内容不同的两条记录。第一条事件：记录用户发起的请求；第二条事件：记录用户请求的操作结果，通常与第一条时间记录有数分钟的延迟，记录用户请求的实际响应结果。两条事件需要结合在一起，才能反映用户本次操作的真实结果。
为什么我的数据会丢失或被删除	不会删除和操作用户的任何数据。出现这种情况，请检查是否为误操作，必要时可利用已有备份恢复文件。目前可采取如下方式：使用的恢复功能，详见恢复备份将备份数据从弹性云服务器导入，详见数据迁移
应用程序是否需要支持自动重连数据库	建议您的应用程序支持自动重连数据库，当数据库重启后，无需人工介入，应用会自动恢复，提供更高的可用性。同时建议您的应用程序采用长连接方式连接数据库，以降低资源消耗，提高性能。
如何开通DIS实例？	用户开通实例方式请参见用户指南开通实例章节。
是否能将一个帐户下的弹性云服务器转移到另一个帐户下？	暂时无法提供帐户资源转移的服务。
无法连接数据仓库集群时怎么处理？	检查原因基本原因可能有以下几种：集群状态是否正常。连接命令是否正确，用户名、密码、IP地址或端口无误。安装客户端的操作系统类型、版本是否正确。安装客户端的操作是否正确。如果是在公有云环境无法连接，还需要检查以下可能导致异常的原因：是否与集群在相同可用分区、VPC、子网和安全组。安全组的出入规则是否正确。如果是在互联网环境无法连接，还需要检查以下可能导致异常的原因：用户网络是否与互联网可以正常连通。用户网络防火墙策略是否限制了访问。用户网络是否需要通过代理才能访问互联网。
如何实现读写分离	读写分离指对RDS主实例配置了一个或者多个只读副本后，DDM可以将写操作分发给主实例执行，将读操作分发给只读副本执行。读写分离极大地提高了数据库的并发性能。读写分离特性一般由DDM内部实现，用户无需在应用代码上做设置。的读写分离模式为：默认事务内的SQL都会走主实例，非事务内的SQL会根据DDM内置的策略选择只读副本执行。也支持用户在SQL中自定义读写分离策略，只需要在SQL前加上指定标签：标签表示事务内走只读副本，事务外的SQL会走主实例，SQL举例如下：标签表示忽略事务状态，强制走主实例，SQL举例如下：标签表示忽略事务状态，强制走只读副本，SQL举例如下：
用户公有云账户欠费给云审计服务带来的影响？	当用户公有云账户欠费时，云审计服务依旧可以接收所支持服务发送的操作信息，但只能保存近7天的操作记录。因为7天之前的历史操作记录会以事件文件的形式实时保存至OBS桶，而将事件文件存储于OBS桶所产生的流量需要付费。此外，云审计服务的追踪器状态会显示为欠费，可以进行配置删除操作，但配置时无法重新选择
外部服务器能否访问DDS	外部服务器暂不能访问，您只能通过ECS来访问它。
集群节点显示不可用？	现象描述集群节点显示不可用，通过linux用户登录node节点执行命令发现docker进程故障，查看docker日志，日志路径为，出现如下类似日志：
消息通知服务的主题名称有何格式要求？	主题名称必须由大写和小写字母，数字，下划线连字符组成，长度在1到256个字符之间，必须由大写、小写字母或数字开头。
云专线接入前期要考虑的要素有哪些？	要考虑的因素有：云专线带宽速率，云专线条数，以及云专线接入的端口类型等因素。云专线带宽速率以运营商提供的速率规格为准。专线条数根据实际情况参考只需要一条还是两条做高可靠性冗余。端口类型分为光口还是电口。
如何获取磁盘加密工具TrueCrypt？	磁盘加密工具TrueCrypt可从华为云开发者中心下载获取，网址为：工具有适用于Windows和Linux操作系统的不同版本，请按实际需求下载使用。
是否支持余额不足提醒？	用户可在充值页面自助设置余额阈值，系统会在用户购买支付时进行余额扣费检查，小于等于阈值则发送提醒。
为何使用了RDS后网站登录较慢	推荐您做如下两个处理：通过RDS管理控制台查看RDS的性能情况。与应用程序有很大关系，使用命令查看当前数据库连接状态，比较本地数据库和RDS的差异。
怎样执行手动扫描检测？	登录管理控制台，选择安全合作伙伴产品中心主机入侵检测，进入主机列表页面。找到需要执行扫描的弹性云服务器，单击手动扫描对于扫描状态扫描完成的弹性云服务器，选择更多扫描详情可查看报告。
ELB支持什么类型的会话保持？	针对7层协议服务，ELB系统是基于cookie的会话保持。针对4层协议服务，ELB系统是基于IP地址的会话保持。
弹性伸缩一定要搭配弹性负载均衡、云监控才能使用吗？	弹性伸缩服务可以单独使用，也可以同弹性负载均衡云监控一起使用。其中，CES服务为免费服务，系统默认开通；ELB服务在有需求时可以部署，例如，有分布式集群需求的场景下，可以使用ELB。
安全指数服务分多少个安全等级？	安全指数服务分为三个等级：安全、低风险、高风险。
怎样启用主机入侵检测？	三步即可启用服务：下载客户端到本地，上传客户端到弹性云服务器。登录弹性云服务器，安装客户端。环境：请使用用户安装客户端，安装成功后客户端自动运行。环境：请使用用户安装客户端，安装成功后客户端自动运行。登录管理控制台，选择安全合作伙伴产品中心主机入侵检测，单击开启检测
为什么入不了会？	入会失败有很多原因，包括网络原因和服务器等，具体错误码在收到CONF消息时会返回，具体参考接口文档。华为公有云环境主要有以下原因、没有调用初始化开发者信息：用户需要调用tup接口初始化开发者的帐号和私钥信息。、帐号不存在：开发者的帐号为华为公有云的帐号，而不是邮箱或手机号码。、帐号和私钥不匹配：开发者的私钥不对，开发者的私钥需要和上传到公有云上的公钥配对。
审核未通过的域名还可以再修改吗？	不可以。如果域名审核未通过，那表明该域名未通过工信部备案。此类域名不允许接入CDN。不过对于正在备案中未审核通过的域名，华为云后台将会定期扫描，如果审核通过后，CDN状态将自动切换到已开启状态。
如何使用Scrum流程项目管理？	项目管理的开发流程分为精简流程项目流程项目，以下介绍Scrum流程项目的操作流程。流程项目管理以层级关系提供了多种类型的工作项，从大到小依次为类型，用户在项目中根据实际需要新建不同类型的工作项，指定责任人、优先级、工作量以及跟踪工作项状态和进度管理等。
不同地域价格是否一样？	目前在国内，不同地域的价格是相同的，但不排除以后地域之间会有价格差异。
占用RDS磁盘空间的日志及文件有哪些	占用RDS磁盘空间的日志及文件如下表：数据库引擎文件类型日志文件：数据库undo、redo和Binlog文件。数据文件：数据库内容文件和索引文件。其他文件：ibdata、ib和临时文件等。日志文件：数据库错误日志文件和事务日志文件。数据文件：数据库内容文件、索引文件、复制槽数据文件、事务状态数据文件和数据库配置文件。其他文件：临时文件。日志文件：数据库的错误日志、事务日志文件和跟踪文件。数据文件：数据库内容文件。
支持Cloudinit特性后，对使用弹性伸缩服务有哪些影响？	是开源的云初始化程序，能够对新创建弹性云服务器中指定的自定义信息主机名、密钥和用户数据等进行初始化配置。在创建伸缩配置时，通过Cloud进行对云服务器的初始化配置。弹性伸缩组使用的伸缩配置中的私有镜像若没有安装Cloud工具，伸缩活动创建的弹性云服务器会出现如下情况：如使用未安装Cloudbase的Windows私有镜像创建的弹性云服务器，在获取弹性云服务器密码时，系统将提示查询不到密码。您只能通过镜像本身的密码登录此云服务器。若忘记镜像本身密码，可以通过云服务器页面重置密码功能，自助完成云服务器的密码重置。如使用未安装Cloud的Linux私有镜像创建的云服务器，使用创建时输入的密码或秘钥将无法正常登录云服务器。您只能通过镜像本身的密码或秘钥登录此云服务器。若忘记镜像本身密码，或镜像本身的秘钥丢失，可以通过云服务器页面重置密码功能，自助完成云服务器的密码重置。如使用未安装Cloud的私有镜像创建云服务器时，用户数据注入会失败。鉴于出现上述情况，在使用弹性伸缩服务时，请检查伸缩配置中的私有镜像是否已经安装并配置了Cloud或者Cloudbase工具，请将使用了未安装Cloud的私有镜像的伸缩配置删除，并使用已安装Cloud的私有镜像创建新的伸缩配置。具体操作步骤：登录管理控制台。选择计算弹性伸缩服务选择伸缩配置页签，进入伸缩配置列表页面。单击创建伸缩配置，选择已安装Cloud或Cloudbase工具的私有镜像创建新的伸缩配置。在伸缩组中将伸缩配置修改为新创建的伸缩配置。
节点状态与应用状态不一致？	当节点的实际状态发生变化时，CCE界面上的节点状态可能不会立即更新延迟大概2分钟，而该节点上的应用状态能够实时更新，所以会出现节点状态与应用状态不一致的现象。
裸金属服务器操作系统自带FTP上传吗？	裸金属服务器操作系统没有自带，FTP需要用户自行安装和配置。
是否可删除已发布的消息？	已发布的消息不能删除。
收到磁盘已挂载的短信后，我要如何启动数据上传？	当您收到磁盘已挂载的短信后，请尽快登录DESConsole，单击待上传AK服务单后的上传AK，根据界面提示，将后台往OBS的桶中上传数据时需要使用的密钥对信息和磁盘解密密码填写到弹出的对话框中。若您没有AK，请通过我的认证页面创建。若没有对磁盘数据加密，可不用填写磁盘解密密码。
不同帐号下弹性云服务器内网是否可以互通？	不同帐号下的弹性云服务器内网是不通的。
无法成功创建数据仓库集群时怎么处理？	检查原因检查是否用户已经没有配额创建新的数据仓库集群。
弹性文件服务用于哪些使用场景？	弹性文件服务可通过文件系统增强工作负载和性能，使用场景包括媒体处理、日志管理、内容管理和主目录和高性能计算等。
云硬盘支持扩容吗	云硬盘支持扩容，数据盘和系统盘均支持扩容。只有云硬盘处于可用状态，即云硬盘没有挂载到云服务器时才可以扩容云硬盘。处于正在使用状态的云硬盘无法进行扩容。
管理员如何参与云服务的试用体验	华为云帐号无法直接登录即时通信客户端，在创建企业时，创建的管理员帐号可以登录客户端。点击放大
为什么DDL命令在Beeling中执行失败？	当Beeling被启动，默认的用户为匿名用户。该用户将不具有权限去写或删除HDFS的内容。因此DDL命令在Beeling中执行失败。解决方法：当启动Beeling窗口时，输入带有参数的用户名。例如：
操作系统是否需要收费？	公有云平台提供的Linux系统和Windows系统不需要您支付版权费用。
使用DES服务后在什么情况下会给我发短信通知？	当服务单申请成功、磁盘挂载成功、数据传输成功和订单关闭时，DES会给您发送短信，让您掌握DES服务单关键进展。
使用云服务器创建私有镜像，需要多长时间？	使用云服务器创建私有镜像，通常需要约20分钟。
使用FunctionStage是否需要开通计算、存储、网络等服务？	用户使用FunctionStage时，不需要开通或者预配置计算、存储、网络等服务，由FunctionStage提供和管理底层计算资源，包括服务器CPU、内存、网络和其他配置资源维护、代码部署、弹性伸缩、负载均衡、安全升级、资源运行情况监控等，用户只需要按照FunctionStage支持的编程语言提供代码，上传即可运行。
华为云帮助中心	如果用户通过外部镜像文件注册私有镜像失败，且在任务中心查看错误信息为外部镜像文件的系统盘容量大于用户设置的系统磁盘容量。此问题通常有两种情况：用户设置的系统盘大小小于原来平台虚拟机的系统盘大小，请重新确认原镜像文件的系统盘大小并重新注册。用户使用的vhd格式是通过qemu或者其他类似工具转换生成，产生的vhd格式的实际虚拟磁盘大小和用户原虚拟机系统盘大小不一致，具体原因参考：此情况下可以通过qemu工具的qemu命令检查处理。计算virtualsize的bytes换算成以G为单位的值是否为整数值。如上所示，2147991552bytes通过换算得到大小约为2大于2G，因此上传时，上传时需要设置系统盘大小大于2G的值。
UQuery支持对接哪些数据源	支持对接以下数据源：
DES服务单有哪些状态？	服务单具有如下几种状态：待寄送磁盘待上传AK正在传输待回寄磁盘传输失败已完成已取消已过期几种状态的转换关系如下图所示：点击放大
弹性云服务器无法启动或连接怎么办？	如果弹性云服务器无法启动或连接，可拨打免费客服电话4000
软件开发云中如何注册华为云用户？	初次使用软件开发云时，需先注册用户；注册成功后，可以登录软件开发云中开始使用服务。说明：软件开发云中项目管理配置管理代码检查编译构建测试管理移动应用测试部署管理发布管理流水线各大服务为同一个注册用户。
如何保存工作表？	为了避免数据丢失，云报表服务会自动保存工作表内容，用户无需手动保存。
云审计服务是否支持事件文件的关键字验证？	支持。原则上进行关键字验证时必须包含以下字段：time、service、resource、trace、trace、trace，其他字段由各服务自己定义。
为什么产品的剩余配额不为零，但是创建产品实例时仍然提示配额不足？	产品的剩余配额是管理员为最终用户分配的该产品可创建的产品实例数，但它受可创建产品实例的总数的限制默认额度为200。当企业内所有用户已创建产品实例的总数超过额度限制时，无法再创建新的产品实例。
什么是DES？	数据快递服务，DataExpressService是一种海量数据传输解决方案，它使用物理存储介质例如：外置USB或SATA硬盘驱动器将大量数据传输到华为云。使用DES可解决海量数据传输的难题包括高昂网络成本、较长传输时间等，DES传输海量数据的速度可高达Internet传输速度的10倍，并且成本可低至Internet费用的五分之一。借助DES，您无需编写任何代码或购买任何硬件即可传输您的数据。只需在DESConsole中创建一个服务单任务，通过线下邮寄磁盘到数据中心的方式，实现数据的高效传输。数据中心会根据需求将磁盘设备挂载到华为云的存储设备上，磁盘挂载成功后，由用户触发传输磁盘数据到对象存储服务的目的桶中，当用户磁盘数据传输完成后数据中心即可返还用户磁盘。用户可以通过短信或直接在DESConsole中跟踪任务状态。
包年包月的弹性云服务器如何变更规格?	您可以随时变更您的弹性云服务器规格。在变更时要先关机，然后选择要变更到的目标云服务器规格，补齐差价后，重启弹性云服务器即可变更成功。说明：用户购买弹性云服务器时，如果选择包年包月并执行变更规格操作，此时，具体规格内存和vCPU的变更只能由小变大，不能由大变小。
通过控制台可以修改哪些参数项（MySQL）	允许通过控制台修改的参数项如下所示：的可配置参数如表1所示。的可配置参数，在表1的基础上新增表2，但不包含表1中以下参数：说明：系统提供的默认参数组不允许修改，只可单击操作列中的查看进行查看。当用户参数设置不合理导致数据库无法启动时，可参考默认参数组重新配置。
基于云服务器制作镜像是免费的吗？	基于云服务器制作镜像是免费的。但后续会收取镜像存储费用。当前阶段为试用期，您可以免费使用。
是否可以修改域名/记录集和反向解析？	记录集和反向解析？域名、记录集和反向解析创建完成后，当前暂不支持对其进行修改。
申请的DDS实例磁盘空间会有哪些系统开销	您申请的磁盘容量会有必要的文件系统开销，这些开销主要包括inode、reservedblock，以及数据库运行必需的空间。
云服务器备份服务有配额限制吗？	云服务器备份服务有配额限制。限定配额仅仅是为了防止资源滥用，如您有更多需求，可以提工单申请扩大配额。
OBS如何保证我的数据不会被盗用？	如何保证我的数据不会被盗用？显示安全性如何保证我的数据不会被盗用？如何保证我的数据不会被盗用？只有桶或对象的拥有者才能访问，访问时需要提供AK，并且还有ACL、桶策略、防盗链等多种访问控制机制保证数据的访问安全。
如果有主机入侵告警产生，应该怎么处理？	目前主机入侵检测只提供基础的检测和告警服务，不提供自动修复功能。对于主机入侵检测和扫描产生的告警，用户需要自己修改弹性云服务器的相应配置进行处理，例如更改检测到的弱口令。
云硬盘有多少种状态	云硬盘有如下几种状态，每种状态的意义及支持的操作如表1所示。表1云硬盘状态描述云硬盘状态状态描述支持的操作正在使用云硬盘已挂载给云服务器，正在使用中。卸载创建备份说明：当共享云硬盘处于正在使用状态时，支持挂载操作。
桶和对象	显示桶和对象桶和对象
云专线是否支持动态路由协议？	专线上路由必须是静态路由，当前还不支持动态路由协议。
设备节点是独占的吗？	设备节点是独占的，您享有对设备节点计算资源的完全使用权，与其他用户完全隔离。
M	将数据源集成到Spark生态系统，使用SparkSQL执行数据查询。也可以使用Spark提供的第三方工具ThriftServer连接到SparkSQL，直接发送请求来完成结构化数据的计算和解析。另外M与SparkSQL完全兼容，支持所有可以直接在SparkSQL上运行的SQL查询操作。
以短信方式接收消息的限制是什么？	按照70个字符计算为一条短信，超过70个字符，则按照67个字符计算为一条短信，短信最长不超过500个字符。
弹性云服务器挂载磁盘时有什么限制？	待挂载的云硬盘与弹性云服务器属于同一可用分区。待挂载的云硬盘为可用状态。弹性云服务器的状态为运行中关机挂载设备类型为SCSI的云硬盘的约束与限制，请参见云硬盘用户指南对于包年包月方式购买的弹性云服务器：在创建云服务器时购买的系统盘，卸载后，如果继续作为系统盘使用，则只能挂载给原云服务器；如果作为数据盘使用，则可以挂载给任意云服务器。在创建云服务器时购买的数据盘，卸载后，如果重新挂载，则只能挂载给原云服务器作数据盘使用。
为什么有时单据识别的结果会不准确？	单据识别的结果不准确时，有以下几个原因：图片格式不支持。目前只支持识别PNG、JPG、JPEG、BMP、TIF格式的图片。图片尺寸过小。图片尺寸不小于1200像素。图片画质太差，例如图片过暗。图片样式不符合单据样式。目前AIS只支持英文海关单据识别。如果有错误码，请参考错误码排查问题。错误码具体说明请参见人工智能服务接口参考
如何修改订阅？	消息中心服务没有权限修改订阅，修改订阅需要在消息通知服务中执行。具体操作请参考消息通知服务用户指南订阅管理章节。
RDS与其他数据库解决方案间的差异	表1与其他数据库解决方案间的差异功能自购服务器搭建数据库服务服务可用性请参见弹性云服务器。需自行保障，自行搭建主从复制，自建RAID等。数据可靠性请参见云硬盘。需自行保障，自行搭建主从复制，自建RAID等。系统安全性防DDoS，及时修复各种数据库安全漏洞。自行部署，价格高昂；自行修复数据库安全漏洞。数据库备份自动备份。自行实现，但需要寻找备份存放空间以及定期验证备份是否可恢复。软硬件投入无软硬件投入，按需付费。数据库服务器成本相对较高。系统托管无托管费用。每台2U服务器每年超过5000元如果需要主从，两台服务器需超过10000元维护成本无需运维。需招聘专职DBA来维护，花费大量人力成本。部署扩容即时开通，快速部署，扩容，按需开通。需硬件采购、机房托管、部署机器等工作，周期较长。资源利用率按实际结算，利用率高。考虑峰值，资源利用率很低。
弹性云服务器怎么防DDoS攻击的？	首先，我们的监控系统会在发现您的流量异常时自动启动流量清洗并建议您封闭不用的端口。同时，我们提供了防DDoS的服务服务，它可以阻止您的弹性云服务器受到非法的攻击。
如何找回软件开发云用户名？	软件开发云提供了三种登录方式：用户名、邮箱、电话号码，如图1所示。图1用户登录
MRS如何收费？	目前MRS商用收费基本要素为集群中弹性云服务器。购买MRS时默认支持按需购买集群节点和包年包月购买集群节点。包年包月：根据集群购买时长，一次性支付集群费用。最短时长为1个月，最长时长为3年。按需付费：节点按实际使用时长计费，计费周期为一小时。按需计费如下：弹性云服务器计费因子：费率、节点数、使用时长。弹性云服务器规格不同，费率就不同。计费公式：费用每小时费率节点数使用时长每小时费率节点数使用时长说明：目前除了启动中错误已终止状态的集群不收费，其他状态的集群都需要收费。此处费用只是购买集群所需费用，MRS上的数据存储、带宽和流量另外计费。扣费时余额不足先提醒用户续费，在保留期冻结集群资源，续费后再解冻。
配置管理各角色类型对应的操作权限是什么？	配置管理中用户的角色类型及对应的操作权限说明，如表1所示。表1角色类型及操作权限角色操作代码仓库成员代码仓库项目创建者添加代码仓库成员、设置成员为仓库管理员仓库管理员可以设置成员为仓库管理员
什么是渗透测试服务？	渗透测试服务，以下简称PTS是一个渗透测试服务单管理平台，用户可以通过该平台创建渗透测试服务单，平台自动以邮件形式将其转发给第三方安全公司。后续商务过程需要用户线下联系第三方安全公司完成，PTS平台不作限制。注意：用户与第三方安全公司之间就渗透测试服务所有合作内容包括但不限于定价、执行渗透测试、获取测试报告、双方权利义务等由用户线下联系第三方安全公司自行协商，并自行决定是否与其签署合作协议。相关服务由第三方安全公司独立向用户提供。PTS平台不以任何形式参与用户与第三方安全公司之间的合作，也不承担任何法律责任。
如何生成接入密钥？	步骤1：在申请服务页面下载密钥生成工具，下载完成后文件名为openssl，如下图所示。步骤2：解压缩openssl后，双击执行openssl，如下图所示。步骤3：先生成私钥文件，在命令行中输入genrsa，在openssl当前路径下会生成文件名为rsa的私钥文件，如下图所示。步骤4：生成公钥文件，在命令行中输入rsa，在openssl当前路径下会生成文件名为rsa的公钥文件，如下图所示。
移动应用测试各角色类型对应的操作权限是什么？	移动应用测试中用户的角色类型及对应的操作权限说明，如表1所示。表1角色类型及操作权限角色操作文件兼容性测试任务项目创建者上传apk、删除apk创建任务、删除任务项目经理上传apk、删除apk创建任务、删除任务测试经理上传apk、删除apk创建任务、删除任务开发人员上传apk、删除自己上传的apk创建任务、删除自己创建的任务测试人员上传apk、删除自己上传的apk创建任务、删除自己创建的任务浏览者查看任务
裸金属服务器与弹性云服务器的主要区别是什么？	弹性云服务器由多个租户共享物理资源，而裸金属服务器的资源归用户独享。对于关键类应用，使用裸金属服务器效果更好。对于性能要求较高的业务，使用裸金属服务器更为合适、性价比更高。
OBS的文件夹与文件系统的文件夹是否一样？	的文件夹与文件系统的文件夹是否一样？显示一般性问题的文件夹与文件系统的文件夹是否一样？的文件夹与文件系统的文件夹是否一样？不一样。由于OBS是一种对象存储服务，并没有文件系统中的文件和文件夹概念。为了使用户更方便进行管理数据，OBS提供了一种方式模拟文件夹。通过在对象的名称中增加，将该对象在管理控制台上模拟成一个文件夹的形式展现。
怎样修改Linux弹性云服务器的静态主机名？	问题描述弹性云服务器的静态主机名来源于创建弹性云服务器时，通过Cloud注入的用户自定义名称。虽然可以使用命令更改Linux弹性云服务器的主机名，但如果重新启动弹性云服务器，它将自动还原为使用Cloud注入的用户自定义名称。
用户误删除Tools后，如何获取数据盘信息？	操作系统下，用户由于误操作卸载弹性云服务器上的Tools，会对非PVOPS系统的磁盘和网卡产生影响，导致系统无法发现数据盘。此时，用户可通过新建一个弹性云服务器，将原数据盘挂载至新创建的弹性云服务器下，从而获取丢失的数据盘信息。具体操作方法如下：登录管理控制台，创建一个新的弹性云服务器。创建方法请参见购买弹性云服务器说明：请确保新创建的弹性云服务器和被误删除Tools的原弹性云服务器在同一个可用分区，且相关参数配置与原弹性云服务器保持一致。
指标数据保留多长时间？	指标数据分为原始指标数据和聚合指标数据。原始指标数据是指原始采样指标数据，原始指标数据一般保留2天。聚合指标数据是指将原始指标数据经过聚合处理后的指标数据，聚合指标数据保留时间根据聚合周期不同而不同，具体如下：聚合周期为5分钟的指标数据，指标保留10天。聚合周期为20分钟的指标数据，指标保留20天。聚合周期为1小时的指标数据，指标保留155天。聚合周期为4小时的指标数据，指标保留300天。聚合周期为1天的指标数据，指标保留5年。如果某个资源实例被停用、关闭或者删除，相应的原始指标数据停止上报1小时后，该指标就被删除，指标恢复上报时，能够查看该指标的历史数据。
为什么用4层ELB后端云服务器访问（如telnet）其实例服务地址不通？	如telnet其实例服务地址不通？这和ELBTCP的实现机制有关。在4层协议服务中，当前不支持添加进后端云服务器池的云服务器既作为RealServer，又作为客户端向所在的ELB实例发送请求。因为，返回的数据包只在云服务器内部转发，不经过ELB，所以通过配置在ELB内的云服务器去访问的公网IP是不通的。
为什么自动备份会失败	出现自动备份失败可能有以下原因：网络环境稳定性不足。如网络延时、中断，系统会识别并延时半小时再次执行备份，您也可以及时进行一次手动备份。系统多任务执行复杂性。如任务等待、中止，系统会识别并延时半小时再次执行备份，您也可以及时进行一次手动备份。实例状态异常。如实例故障、状态变更中，系统会识别并在状态恢复正常后再次执行备份，您也可以及时进行一次手动备份。参数修改异常。如修改参数并关联实例后导致实例故障，您可以对比参数修改前后的值是否正确、修改的参数是否存在关联参数需要一并修改、或者尝试恢复默认参数重启实例。导入数据异常。如导入数据不当导致系统表记录丢失，您可以参考导入数据重新导入数据。如果以上操作仍无法解决问题，请联系技术支持。
我能启用多少个伸缩策略？	伸缩策略可以启用一个，也可以启用多个。
虚拟打印驱动没有安装成功，导致文档共享失败	开始设备和打印机，查看是否有HuaweiDocumentPrinter打印机，如果没有则表示没有安装华为虚拟打印。虚拟打印安装需要管理员权限，非管理员用户不能安装。另外安装的时候注意UAC权限，如果系统开启UAC，安装虚拟打印时会提示是否安装运行，选择是，否则虚拟打印安装不上。文档共享过程中，程序会按需自动安装打印驱动程序。
连接镜像仓库时下载的认证文件是否会过期？	会过期，认证文件默认有效时间为一年，超过期限需要重新下载认证文件，然后配置Docker客户端。
裸金属服务器是否提供高性能磁盘？	当前裸金属服务器本地磁盘仅支持SATA及SAS磁盘。
分布式缓存服务的备节点是否会与其主节点同步保持最新状态？	一般情况下，主节点的更新会自动复制到关联的备节点。但由于Redis异步同步的技术，备节点更新可能会落后于主节点。例如，主节点的I写入速度超过了备节点的同步速度，或者因异常原因导致的主节点和备节点的网络延迟，使得备节点与主节点存在滞后或者部分数据不一致，若此时进行主备切换，未同步的少量数据可能会丢失。
弹性负载均衡的带宽是否可调整？	公网弹性负载均衡的带宽可以调整。调整范围为1调整带宽的具体操作请参考负载均衡器管理章节的调整带宽部分的内容。
告警通知是什么，怎么设置，分为几类？	告警通知是告警在某个告警状态触发时所采取的行为，用户可以在创建、修改告警的时候设置通知，也可以关闭通知。通知目前支持两种：触发告警时给用户发送Email、短信通知或发送HTTPPOST消息给服务器。与弹性伸缩联动触发弹性伸缩自动扩容和减容。
如何处理VNC方式登录弹性云服务器后，较长时间不操作，界面无响应？	用户的计算机操作系统为Windows7时，如果使用IE10或IE11浏览器通过VNC方式登录弹性云服务器，且较长时间不做任何操作，VNC登录界面会出现无响应的状况，键盘和鼠标无法正常操作，可以通过单击两次VNC页面上的按钮重新激活页面。
如何解决上传软件包失败的问题？	问题描述在上传软件包时，在软件包满足系统要求的情况下，界面依然出现如下提示：上传软件包后，系统提示无权限访问，请联系管理员
RDS存储的存储配置是什么	数据库存储采用EVS，关于云硬盘具体信息，请参见云硬盘用户指南的备份数据存储采用OBS，不占用用户购买的数据库空间。关于RDS实例存储的硬件配置，请参见对象存储服务用户指南
UQuery适用哪些场景	用户使用UQuery有四类场景：明细数据查询典型应用：设备运维仪表盘，故障分析，能耗统计，轨迹回放，医疗健康报告，用户行为事件分析等。场景特点：海量数据，查询的有效数据不大，查询往往携带过滤条件如时间等，查询维度不固定。企业商业智能分析典型应用：流水审计，经营状况分析，行情分析，业务报表，订单跟踪等。场景特点：往往对接BI工具协同分析，分析维度不固定，常涉及多个表联合查询，响应时延低。政府公共事务统计典型应用：人口住房统计，犯罪追踪，关联案件查询，交通拥堵分析，景点热度统计。场景特点：统计计算，对比分析，响应时间要求通常不苛刻。海量日志分析典型应用：新媒体热点事件追踪，消息来源分类筛选，广告收益统计等。场景特点：半结构化，海量数据，部分涉及模糊查询，计算量大。
机器学习服务是什么？	机器学习服务，即MachineLearningService，简称MLS，是一项数据挖掘分析平台服务，旨在帮助用户通过机器学习技术发现已有数据中的规律，从而创建机器学习模型，并基于机器学习模型处理新的数据，为业务应用生成预测结果。
什么是数据加密密钥？	数据加密密钥是用于加密数据的密钥。
如何获取客户端安装包？	方法一通过华为云会议产品下载页面获取。您可使用浏览器登录华为云会议产品下载页面，获取Windows或Mac版本的PC客户端安装包，以及Android版的移动客户端安装包。说明：版本客户端请通过AppStore获取。
备份云服务器需要多长时间？	云服务器备份首次为全量备份，后续均为增量备份。因此第一次备份时间较长，后续备份时间较短。例如：备份一个已有数据为100GB的云服务器，首次全量备份需要30分钟左右；假设下次备份前新产生或变化数据量为15GB时，增量备份需要6分钟左右。
数据库在备份窗口中是否可用	备份窗口是用户定义的时间段，在该时间段内实例将进行备份。借助这些定期数据备份，让您能够将实例还原到保留期内的备份点。在备份时段期间，业务不受影响，但不能在控制台做重启操作。
一台云服务器可以挂载几块云硬盘	一台云服务器可以挂载10块云硬盘。
什么是启动约束？	启动约束是通过云目录服务代理没有产品资源权限的用户来创建产品实例。
CloudStream支持哪些数据源？	可以处理来自数据接入服务和对象存储服务的数据。
云专线使用方式有几种?	云专线目前仅支持包周期，分别是包月、包年。
如何查看日志信息？	操作日志页面记录了用户对集群和作业的操作的日志信息。目前，MRS界面记录的日志信息分为2类：集群操作创建集群、删除集群和扩容集群创建目录、删除目录和删除文件作业操作：创建作业、停止作业和删除作业记录用户操作的日志信息如图1所示：图1日志信息点击放大
为什么数据表会丢失或数据被删除	不会删除和操作用户的任何数据。出现这种情况，请检查是否为误操作，必要时可利用已有备份恢复文件。目前可采取如下方式：使用RDS实例的恢复功能。将备份数据从弹性云服务器导入RDS数据库。
如何准备M	的数据源？执行LOADDATA命令时，需要从HDFS获取数据源，目前不支持从OBS获取数据。故要将数据源上传到OBS，再使用集群导入功能将OBS数据导入至HDFS中。将本地数据上传OBS。登录OBS服务在OBS上创建桶userdata，然后在userdata下创建input。单击创建桶，创建一个userdata桶。在userdata桶下单击新建文件夹，创建input目录。上传数据至userdata桶。进入input文件夹，单击点击放大选择用户程序。单击上传将用户数据文件上传至input目录。将OBS数据导入至HDFS。登录M服务进入文件管理页面，选择文件列表进入数据存储目录，如目录仅为示例，可以是界面上的任何目录，也可以通过新建创建新的目录。单击导入，通过点击放大选择OBS和HDFS路径，如图1所示。图1导入文件
容灾基础faq	显示容灾基础FAQ容灾基础FAQ什么是容灾？容灾主要的目的是什么？容灾是一个范畴比较广泛的概念。广义上，容灾是一个系统工程，包括所有与业务连续性相关的内容。对于IT而言，容灾就是提供一个能防止用户业务系统遭受各种灾难影响破坏的计算机系统。容灾还表现为一种未雨绸缪的主动性。狭义的容灾是指建立两套或多套功能相同的IT系统，互相之间可以进行健康状态监视和功能切换，当一处系统因意外如火灾、地震等停止工作时，整个应用系统可以切换到另一处，使得该系统功能可以继续正常工作。容灾的主要目的是，当自然或人为的原因导致生产系统发生灾难时，能够尽可能地保证业务的连续性。、RPO是什么？指灾难发生后，信息系统或业务功能从停顿到恢复的时间要求。指灾难发生后，系统和数据恢复到的时间点要求。点击放大点击放大如何制定系统切换的RTO指标？：RTO是业务系统对容灾切换时间的要求，通常由业务影响分析得出。另一方面，从容灾系统设计的角度来看，是当期容灾系统切换的时间，不能仅仅从存储层面考虑，而要从应用系统整体考虑，包括存储、数据库和应用等几方面，要以能接管业务的耗时为准。容灾和备份的区别是什么？、容灾主要针对火灾、地震等重大自然灾害，因此容灾中心与生产中心间必须保证一定的安全距离；备份主要针对人为误操作、病毒感染、逻辑错误等因素，用于业务系统的数据恢复，数据备份一般是在同一数据中心进行。、容灾系统不仅保护数据，更重要的目的在于保证业务的连续性；而数据备份系统只保护不同时间点版本的数据的可恢复，数据恢复的时间一般比较长。、容灾的最高等级可实现RPO；而备份则能恢复出备份时间点以前的历史数据，通常每天备份一次、故障情况下，容灾系统的切换时间可降低至几分钟甚至零切换时间；而备份系统的恢复时间可能几小时到几十小时。什么是容灾演练，它包括哪些内容？容灾演练是指模拟灾难发生时，根据灾难恢复预案进行的业务恢复过程。对于容灾演练而言，应该作为一个完整的项目对待，包括启动，计划，实施，控制和收尾阶段。需要正式的启动会议，得到领导层以及相关部门的配合和认可。需要详尽的计划包含如下内容：演练的场景及方案计划、详细的人员和工作安排、认真细致的风险评估以及应急方案、完善的演练准备工作以及相关测试。实施和控制：安排演练的主持人对整个过程进行引导和控制，专人记录演练的进展和发现的问题。演练完成后一定要进行演练总结和报告，对DRP进行必要的修订，并安排后续工作。由于容灾演练涉及容灾演练的预案制定、网络以及应用系统、存储设备等全方位的知识，是一项复杂的系统工程，建议与专业容灾服务的厂商来联合撰写方案及执行演练。：什么是容灾测试？容灾测试是为了定期检验容灾中心存储设备的数据可用性或者完整性，确保容灾中心的业务数据可用性以及满足RPO的容灾要求。容灾测试流程主要通过测试和清理两个动作来完成，测试流程的执行不影响生产系统和容灾过程。：基于存储的容灾方案是否只能做数据级容灾，不能做应用级容灾？首先需要理解数据级容灾和应用级容灾的概念：数据级容灾是指通过建立异地容灾中心，做数据的远程备份，在灾难发生之后要确保原有的数据不会丢失或者遭到破坏，但在数据级容灾这个级别，发生灾难时应用是会中断的。在数据级容灾方式下，所建立的异地容灾中心可以简单地把它理解成一个远程的数据备份中心。数据级容灾的恢复时间比较长，但是相比其他容灾级别来讲它的费用比较低，而且构建实施也相对简单。应用级容灾是在数据级容灾的基础之上，在容灾站点同样构建一套相同的应用系统，通过同步或异步复制技术，这样可以保证关键应用在允许的时间范围内恢复运行，尽可能减少灾难带来的损失，让用户基本感受不到灾难的发生，这样就使系统所提供的服务是完整的、可靠的和安全的。应用级容灾生产中心和异地容灾中心之间的数据传输是采用异类的广域网传输方式；同时应用级容灾系统需要通过更多的软件来实现，可以使多种应用在灾难发生时可以进行快速切换，确保业务的连续性。因此基于存储层和主机层的复制都可以实现应用级或数据级的容灾。华为的主备容灾方案、双活数据中心、两地三中心容灾方案配合容灾管理软件及备份的应用系统都可以做到应用级容灾。容灾的标准有哪些？如何衡量容灾系统？信息技术信息安全管理实用规则、GB信息安全风险评估指南、DRIInternational国际灾难恢复协会、ISACA信息系统审计与控制协会、NIST美国国家标准和技术学会信息系统灾难恢复规范是不是容灾等级越高的方案就是最适合客户的方案？为什么？容灾方案的等级越高，就可以实现更小的RPO和RTO，可以更好地保证业务连续性。但是更小的RPO和RTO同时也意味着容灾系统建设投资的成本和复杂度也会更高。因此，容灾系统的建设应该考虑业务系统的重要性，分析数据和应用系统可能面临哪些风险或灾难、以及业务系统出现意外故障时对企业带来的影响。结合上述分析结果，针对不同的业务系统选择适合的RPO和RTO，确定最佳的容灾解决方案，满足业务系统的容灾需求。容灾系统只能通过光纤链路来实现吗？数据传输采用FC协议还是IP协议？不一定，依据容灾系统采用的容灾技术与方案。我司的复制技术对容灾链路的要求如下：复制技术数据传输协议阵列同步复制阵列异步复制存储双活存储复制：FC心跳网络：IP
云专线的价格是多少?	云专线定价，1GE端口1月收费560元人民币，1年收费是560元人民币；10GE端口1月收费3720元人民币，1年收费3720元人民币。
发布管理各角色类型对应的操作权限是什么？	发布管理中用户的角色类型及对应的操作权限说明，如表1所示。表1角色类型及操作权限角色操作构建包下载用户名和密码重置密码项目创建者上传、下载、查看、删除构建包有管理员权限的项目创建者可以下载用户名和密码有管理员权限的项目创建者可以下载用户名和密码项目经理上传、下载、查看、删除构建包测试经理开发人员上传、下载、查看构建包开发人员跨租户下载、查看构建包测试人员浏览者
MRS支持哪些作业类型？	作业是MRS为用户提供的程序执行平台，当前MRS支持MR、Spark和Hive作业，作业的特点及区别如表1所示。表1作业类型类型说明，一种简化并行计算的编程模型，用于大数据集大于1TB的并行运算。将一个任务分解成为多个任务，Reduce将分解后多任务处理的结果汇总起来，得出最终的分析结果。用户完成代码开发后，在IDEA或Eclipse中打包成Jar包，上传到MRS集群中执行并获取执行结果。数据批量处理引擎，数据处理速度快，但Spark是基于内存进行计算，对内存要求较高。Spark作业包括：：需要以结尾，jar不区分大小写：需要以结尾，sql不区分大小写：规范的SparkSQL语句，例如：是建立在Hadoop上的数据仓库框架，提供类似SQL的HiveQL语言操作结构化数据，其基本原理是将HiveScript中的HiveQL语言自动转换成MapReduce任务，从而完成对Hadoop集群中存储的海量数据进行查询和分析。规范的HiveQL语句，例如：
多台弹性云服务器是否可以使用同一个RDS数据库	在数据库的压力承载范围内，多台弹性云服务器ECS是可以使用同一个RDS来支撑业务的。
提交语句失败如何定位？	用户提交语句之后，可以在页面看到执行中的提示，但有时候看不到结果。执行成功，但是结果集为空。点击放大上述情况为正常现象，表明查询结果为空。执行失败，有错误提示。点击放大一般来说，从反馈的日志可以初步定位出原因。如果是提示语法错误，则检查DDL命令格式是否正确，如下所示。点击放大如果是数据源不存在，则在文件管理中检查数据路径是否正确，如下所示。点击放大如果从页面无法定位，则用户可向系统提交工单请求技术支持。
为什么不能马上删除用户密钥？	删除密钥是一个需要非常谨慎的操作。操作前，用户需确保使用该密钥加密的相关数据都已完成迁移。因为密钥一旦被删除，所有使用该密钥加密的相关数据都无法解密。因此在删除密钥时，KMS会将该操作推迟7天到1096天执行，推迟时间由用户指定。超过推迟时间，密钥才会被真正删除。在密钥被真正删除之前，如果用户发现该密钥仍然有用，可取消删除操作。KMS通过这种方式来减少用户误操作所带来的损失。
客户端初次使用如何配置？	配置PC客户端打开TEDesktop客户端，在登录界面右下方单击，在服务器注册服务器地址中，选择华为云会议，单击保存配置移动客户端打开TEMobile客户端，在登录界面右下方单击，在服务器地址中，选择华为云会议，点击保存
DDS能够保存多长时间的备份	自动备份可保留天数默认7天。备份空间不占用用户购买的数据库空间。手动备份没有时间限制，且用户可根据需要删除该备份文件。
产品发布了新版本后，如何让最终用户使用？	管理员将产品的新版本发布后，所有已获得该产品使用权限的最终用户即可以直接查看和使用。
如何自定义添加监控项?	用户在总览页面，监控面板区域，单击点击放大。在添加监控项界面，根据界面提示选择关注的指标就可以了。
弹性负载均衡服务是否收费？	弹性负载均衡服务提供按需收费方式。
重启/关机弹性云服务器时，长时间处于“正在重启”/“正在关机”状态，怎么办？	关机弹性云服务器时，长时间处于正在重启正在关机状态，怎么办？如果对弹性云服务器执行重启关机操作，弹性云服务器长时间大于30分钟处于正在重启正在关机状态时，建议执行强制重启强制关机操作。登录管理控制台。选择计算弹性云服务器勾选待强制重启强制关机的弹性云服务器，并单击重启关机系统弹窗提示用户是否要对弹性云服务器进行重启关机操作。勾选强制重启强制关机，确定强制重启强制关机弹性云服务器。单击确定
云服务器备份出现异常该如何处理？	目前异常状态主要为云服务器备份状态异常。当处于这些状态时，请参考下面处理建议。表1云服务器备份状态异常处理建议异常状态建议错误您可以删除错误状态的云服务器备份后，再重新创建。删除失败请联系客服解决。客服会主动帮您解决此问题，在此之前建议不要对该备份数据做其他操作。如果您对客服响应速度有要求，请主动联系。
数据库在备份窗口中是否可用	备份窗口是用户定义的时间段，在该时间段内RDS实例将进行备份。RDS借助这些定期数据备份，让您能够将RDS实例还原到保留期内的备份点。在备份时段期间，业务不受影响，但不能在RDS控制台做重启操作。
UQuery的用户需要什么技能	的用户能熟练的操作SQL语句。
视频质量比较模糊	、查看打开的视频设置的分辨率是否太小。、查看自己观看的是高流视频还是低流视频。
OBS可以用来做什么？	可以用来做什么？显示一般性问题可以用来做什么？可以用来做什么？为用户提供了超大存储容量的能力，适合存放任意类型的文件，适合普通用户、网站、企业和开发者使用。由于OBS是一项面向Internet访问的服务，提供了基于HTTP协议的Web服务接口，用户可以随时随地在任意可以连接至Internet的电脑上，通过OBS管理控制台或客户端访问和管理存储在OBS中的数据。此外，OBS支持JAVA、Python、、iOS、C、Android、Ruby、PHP等语言的SDK、以及兼容AmazonS3原生接口的RESTAPI接口，可使用户方便管理自己存储在OBS上的数据，以及开发多种类型的上层业务应用。
我能否自己安装或者升级操作系统？	裸金属服务器需要使用我们提供的操作系统，不能自行添加或升级，操作系统可以打补丁。
什么样的产品可以切换操作系统？	切换操作系统功能当前仅支持按需付费方式购买的弹性云服务器，且其挂载的系统盘也必须为按需方式购买的。包年包月方式购买的弹性云服务器当前不能切换操作系统。
健康检查异常如何排查？	的健康检查是通过ELB系统向后端云服务器发起心跳检查的方式来实现的，而ELB系统和云服务器之间是通过内网进行通信的，为了确保健康检查工作的正常进行，您需要确保能够通过内网访问您的云服务器，请按照以下方法排查。在监听器页面，在健康检查异常的监听器所在行，单击健康检查列下的查看弹出健康检查配置项提示框，如图1所示。检查健康检查方式：确保后端服务器已配置相应协议并开启端口。检查检查路径：如果是使用HTTP协议进行健康检查，还应检查后端主机的健康检查路径是否正确。图1健康检查配置项
未安装VMTools对弹性云服务器监控指标有什么影响?	未安装VMTools，云监控服务无法提供监控弹性云服务器的内存使用率、磁盘使用率、带内网络流入速率和带内网络流出速率四个指标。但可以监控带外网络流入速率和带外网络流出速率指标，这样导致CPU使用率指标的精确性可能会降低。如果弹性云服务器类型是IO优化实例，无论是否安装了vmtools，云监控服务监控弹性云服务器的监控指标不包含磁盘使用率、带内网络流入速率和带内网络流出速率指标。弹性云服务器支持的监控指标，请参见弹性云服务器支持的监控指标
DIS主要应用于哪些场景？	对于从数据生产者快速移出数据，然后进行持续处理非常有用。以下是使用DIS的典型情景：加速日志和数据传送获取：您无需等待批量处理数据，而是让数据生产者在生成数据后立即输入DIS数据通道，防止因数据生产者出现故障导致的数据损失。例如，系统和应用程序日志可以持续添加到数据通道并可在数秒内进行处理。实时指标和报告：您可以实时从DIS数据通道数据提取指标并生成报告。例如，您的DIS应用程序可以处理系统和应用程序日志的指标和报告，因为数据被流入而不是等待收到批量数据。实时数据分析：通过DIS，您可以运行实时通道数据分析。例如，您可以通过单击通道将其添加到DIS数据通道中，并让您的DIS应用程序实时运行分析，从而在数分钟内从数据中获得重要见解，而无需数小时或数天时间。复杂的数据通道处理：您可以创建DIS应用程序和数据通道的DirectedAcyclicGraphs。在这一情景中，一个或多个DIS应用程序可将数据添加到一个DIS数据通道进行进一步处理，以便于进行通道处理器的后续阶段。
将根证书导入Windows操作系统	操作步骤单击开始，运行框输入，回车。在MMC控制台菜单栏中单击，选择对话框，选择区域的，单击添加证书。对话框，选择，单击对话框，单击对话框，单击在MMC控制台，双击，右键单击，选择，单击单击单击，将文件类型更改为，找到下载的根证书ca文件，单击，然后在向导中单击注意：您必须在浏览窗口中将文件类型更改为才能执行此操作，因为不是标准证书扩展名。
如何自动初始化弹性伸缩新增的云服务器数据盘？	操作场景云服务器创建完成后，数据盘需要初始化后才能使用。当使用弹性伸缩为伸缩组增加数量较多的云服务器时，您就需要逐一手动初始化数据盘，将会占用较长时间。本节为您介绍通过脚本自动化完成初始化磁盘的操作，包括磁盘分区和挂载指定目录。本节介绍的自动初始化脚本示例仅支持初始化一个数据盘。本节操作以centos6为例。其他操作系统配置方法略有区别，请参考对应操作系统的相关资料进行操作，文档中不对此进行详细说明。
什么是容器集群？	支持创建容器集群和共享集群。容器集群用于运行Docker应用，在创建Docker应用前，您需要先创建容器集群，容器集群是私有集群，对其他用户不可见，可以保证您的容器应用与其他用户的应用之间更安全的隔离。共享集群可供用户免费体验，方便用户更快的体验CCE服务。每个用户最多能够创建2个集群。集群由一个或多个节点组成，每个集群最多15个节点。当前，CCE使用的Docker版本已从1升级到1说明：版本的升级，不涉及已经创建好的集群。老集群所用的Docker版本仍为1
什么是接入密钥？	接入密钥为用户接入使用服务的鉴权密钥，由一对公钥和私钥组成，用户开通服务时需要将公钥上传，并需将私钥妥善保管。
什么是服务单？	服务单，是用户在PTS平台创建并提交给第三方安全公司执行渗透测试的订单，系统以邮件形式将服务单发送给安全公司，用户线下联系安全公司执行渗透测试。
机器学习服务的优势有哪些？	机器学习服务可降低机器学习使用门槛，提供可视化的操作界面来编排机器学习模型的训练、评估和预测过程，无缝衔接数据分析和预测应用，降低机器学习模型的生命周期管理难度，为用户的数据挖掘分析业务提供易用、高效、高性能的平台服务。易用性强，技术门槛低内置分类、回归、聚类、数据处理等常用建模节点，用户通过拖拽式操作即可在可视化的工作流编排界面数据建模，降低建模难度。可视化操作，直观高效实现数据可视化，内置丰富的图表类型，不同的数据可以选择不同的图表类型进行展示，所见即所得，提升数据探索效率。模型应用提供模型应用算子，支持在工作流中导入训练完成的模型，提供批量预测的能力。
消息较少时单次消费不能获取指定数量的消息	一个队列中的消息存储在多个不同的分区，多分区设计提升了消费并发度，最大可同时处理同一个消费组的多个消费请求。为了性能考虑，每个消费请求只能消费一个分区中的消息，避免跨多个分区缓存管理和访问带来性能损失，当消息数量较少时，单个分区的消息数量可能小于指定的消费消息数量，这样单次消费请求返回的消息数会少于指定的消费消息数量，但是多次消费请求会自动负载均衡到不同的分区，所有分区的消息最终都将被消费。
裸金属服务器主要有哪些应用场景？	裸金属服务器提供更加稳定、强大的性能，因此适用于对性能要求很高的应用。典型应用场景包括：关系数据库和NoSQL数据库、内存分析解决方案、分布式高速缓存系统、大规模在线移动广告平台、大数据类应用、游戏、3D渲染、通信平台、移动商务平台。
我可以使用哪些语言的SDK开发包？	我可以使用哪些语言的SDK开发包？显示一般性问题我可以使用哪些语言的SDK开发包？我可以使用哪些语言的SDK开发包？支持JAVA、Python、、iOS、C、Android、Ruby、PHP等语言的SDK，当前已提供JAVA、Python、、C、Android、Ruby、PHP的SDK和SDK参考文档供下载。您可以在开发者中心中搜索并下载这些资源。
可以使用设备节点上的硬盘吗？	仅支持使用设备节点上的计算资源，不能直接使用设备节点上的硬盘。
云专线怎么接入？	根据业务需求按模板填写专线申请，联系运营商商务谈判签订合同，运营商安排实施工程师接通两端物理线路，运维工程师配合进行连接配置，验收测试，确认专线连接的两端主机通信正常，专线开通完成。
可以向主题发布多少条消息？	向主题发布消息没有限量。
RDS实例是否会受其他用户实例的影响	实例不会受其他用户实例影响，因为每个用户的RDS实例与其他用户的RDS实例是独立的，并且有资源隔离，互不影响。
云服务器快过期了，我还想继续用，该怎么办？	需要在管理控制台的用户中心订单管理中进行续订。
如何找回软件开发云用户密码？	背景信息软件开发云找回用户密码分为三种情况：管理员用户通过登录页面找回密码。普通用户通过登录页面找回密码。普通用户通过管理员从管理控制台重置密码。说明：管理员用户为注册的华为云用户，普通用户为管理员创建的用户。
如何准备MRS的数据源？	既可以处理OBS中的数据，也可以处理HDFS中的数据。在使用MRS分析数据前，需要先准备数据。将本地数据上传OBS。登录OBS管理控制台。在OBS上创建userdata桶，然后在userdata桶下创建program、input、output和log文件夹。单击创建桶，创建一个名称为userdata的桶。在userdata桶下单击新建文件夹，分别创建program、input、output和log目录。上传数据至userdata桶。进入program文件夹，单击点击放大选择用户程序。单击上传使用同样方式将用户数据文件上传至input目录。将OBS数据导入至HDFS。认证关闭，且运行中的集群，可执行将OBS数据导入至HDFS的操作。登录MRS管理控制台。进入文件管理页面，选择文件列表进入数据存储目录，如目录仅为示例，可以是界面上的任何目录，也可以通过新建创建新的目录。单击导入数据，通过点击放大选择OBS和HDFS路径，如图1所示。图1导入文件
哪些内容会占用我所购买的DDS实例空间	您正常的数据不包括备份数据，以及实例正常运行所需的数据比如系统数据库、数据库回滚日志、索引等。同时，产生的日志输出文件也会占用空间。这些文件会保证实例正常稳定地运行。
后台管理人员能否导出我存在OBS中的数据？	后台管理人员能否导出我存在OBS中的数据？显示安全性后台管理人员能否导出我存在OBS中的数据？后台管理人员能否导出我存在OBS中的数据？管理员无法导出用户数据。访问桶或对象时，如果桶或对象未公开，只有桶或对象的拥有者才能够访问，访问时需要提供安全密钥和SK
我从DataPipelineService用户界面最多可以创建多少个Pipeline？	目前默认每个用户最多可以创建10个Pipeline，同时系统支持用户根据实际需求调整最大配额。
卸载云硬盘时数据会丢失吗	不会。为了保证您的数据不丢失，我们建议按照以下流程卸载云硬盘：关闭待卸载云硬盘所挂载的云服务器云服务器关机后，卸载云硬盘。
“有状态容器应用”和“无状态容器应用”有什么不同？	无状态容器应用有什么不同？有状态容器应用：应用有多个实例，且每个实例承担不一样的功能，且每个实例间有依赖和前后启动顺序关系。通常用于有数据持久化存储要求的应用。无状态容器应用：应用实例间互相不依赖，任意一个Web请求完全与其他请求隔离，当请求端提出请求时，请求本身包含了相应端为相应这一请求所需的全部信息。无状态容器应用更易实现可靠性以及可伸缩性。
项目管理的成员如何设置为管理员？	项目管理员、非项目创建者，能添加其他成员为管理员吗？只有项目创建者，才有权限添加其他成员为项目管理员；普通项目管理员不能添加其他成员为项目管理员。
弹性云服务器上是否可以搭建数据库？	可以，我们不限制。您可以安装任何类型的数据库。
支持创建多少个域名/记录集/反向解析？	记录集反向解析？默认情况下，一个用户支持创建50个公网域名、500个记录集和50个反向解析。如果配额不满足实际需求，可以联系客服人员申请扩容。
CloudStream适用哪些场景？	服务的使用，聚焦于互联网和物联网场景，适用于实时性要求高、吞吐量大的业务场景。主要应用在互联网行业中小企业物联网车联网金融反欺诈等多种行业应用场景，如，互联网汽车、日志在线分析、在线机器学习、在线图计算、在线推荐算法应用等。实时流分析场景应用：实时大数据分析。场景特点：面向流数据，支持window、CEP、Join等复杂的流分析操作，毫秒级延迟。适用场景：在线分析，金融风控，交通流量分析，ETL，实时决策。物联网IOT场景应用：物联网在线数据分析。场景特点：物联网IoT直接调用CloudStream服务API，CloudStream可以实时读取传感器信息并执行用户的分析逻辑，分析结果对接到DIS、RDS等服务用于可视化、持久化、告警或报表展示。适用场景：电梯IoT、工业IoT、共享单车、互联网汽车和智能家居。
未绑定弹性IP的弹性云服务器能否访问外网？	能。公有云提供了免费的SNAT服务，支持创建的弹性云服务器默认使用有限带宽单向访问Internet，便于用户进行软件更新等操作，但是从Internet无法直接访问该弹性云服务器。即这种方式只能使弹性云服务器访问外部网络，外部网络不能直接访问弹性云服务器，且用户创建的所有弹性云服务器共享带宽。服务的工作原理请参见虚拟私有云用户指南。如果不需要使用此项访问外网的免费服务，您可以通过限制弹性云服务器所在安全组的出方向规则禁止其访问外网。具体方法如下：假设用户需要禁止弹性云服务器访问外网，同时又要让其访问192网段，则需要在安全组中进行如下配置：删除安全组中的默认出方向全通规则。该规则删除过后虚拟机将不能向外访问任何网络，包括VPC内部的网络。图1删除默认出方向安全组规则点击放大
安全性	显示安全性安全性
如何安装PostgreSQL客户端	官网提供了针对不同操作系统的客户端安装包，以及包含动态依赖库的软件包。RedHatLinux6下PostgreSQL9最新版本的单击此处下载，下面将以该版本为例，介绍如何获取相应安装包及完成安装。操作步骤获取PostgreSQL客户端安装包。在下载页面找到对应版本的链接，以postgresql95为例，打开页面后，即可下载安装包。图1下载PG客户端点击放大
启用云审计服务是否会影响其他云服务资源的性能？	不会。启用云审计服务不会影响其他云服务资源的性能。
为什么在产品组合里移除了对某个用户的授权，但是在配额管理里仍然可以看到该用户的配额数据？	能的原因有以下几种：产品在别的产品组合中被授权给该用户。用户在该产品上的已使用额度不为零。数据清理需要花费大约1分钟，请耐心等待。
如何创建DES服务单？	登录DESConsole。单击立即申请点击放大填写传输信息点击放大磁盘目录：填写磁盘根目录下文件夹名称例如：folder1，不支持填写如下格式：。若填写文件夹名称，表示将该文件夹中的所有数据传输到指定的目的桶中；若不填写，则默认将磁盘中所有文件传输到目的桶。一个输入框中只能填写一个文件夹名称，若需要传输多个文件夹，可单击添加，填写多个不同的磁盘目录。例如：用户磁盘中的根目录下包含两个文件，用户可将这两个文件分别填写到不同的磁盘目录的输入框中，且可以选择不同的目的桶，实现数据分类。目的桶：选择磁盘数据传输的目的桶。若目的桶不存在，需要使用对象存储服务创建可用的桶后，再刷新目的桶并重试。数据中心：目的桶选择后，数据中心值会根据目的桶所在数据中心自动获取。填写联系信息点击放大联系人：填写设备回邮联系人姓名。手机号码：填写设备回邮联系人手机号码。磁盘回邮地址：填写设备回邮地址。单击立即申请，进入服务单详情界面。点击放大确认服务单详情信息无误后，勾选我已经阅读并同意华为数据传输服务协议单击提交申请，提交服务单。服务单详情信息有误，可单击上一步，修改服务单信息后再提交服务单。服务单创建成功后，进入如下图所示界面。点击放大可选单击磁盘加密工具下载，下载加密工具，并加密磁盘数据。
一台弹性云服务器是否可以绑定多个弹性IP？	可以，但是我们不建议您这样操作。如果需要配置多个弹性IP，则需要您手工配置路由策略。
UQuery支持哪些数据格式	支持如下数据格式：
什么是云服务器备份？	云服务器备份服务，CloudServerBackupService可为云服务器创建备份，利用多个云硬盘一致性备份数据恢复云服务器业务数据，最大限度保障用户数据的安全性和正确性，确保业务安全。
我能否自己安装或者升级操作系统？	弹性云服务器需要使用我们提供的操作系统或者基于我们操作系统制作的操作系统，不能自行添加或升级，操作系统可以打补丁。
什么是DIS？	数据接入服务为处理或分析流数据的自定义应用程序构建数据流管道，主要解决云服务外的数据实时传输到云服务内的问题。数据接入服务每小时可从数十万种数据源如IoT数据采集、日志和定位追踪事件、网站点击流、社交媒体源等中连续捕获、传送和存储数TB数据。
对象URL	显示对象URL对象URL
与FunctionStage相关联的服务有哪些？	与FunctionStage相关联的华为云服务有：IAM统一身份认证服务、SMN消息通知服务、DMS分布式消息服务使用FunctionStage创建函数之前需要在IAM创建委托，用以身份验证。使用FunctionStage创建SMN触发器之前需要在SMN创建主题，用以订阅消息主题。使用FunctionStage创建DMS触发器之前需要在DMS创建队列消费组，用以定期拉取消息。
软件开发云为开发者提供了哪些服务？	华为软件开发云提供了项目管理、配置管理、流水线、代码检查、编译构建、部署、测试管理、移动应用测试、发布管理和CloudIDE服务，各服务功能描述及适用场景，如表1所示。表1软件开发云各服务功能及适用场景服务名称功能描述适用场景项目管理项目管理为软件开发团队提供敏捷化项目管理协作服务，提供多项目管理、敏捷迭代管理、需求管理、缺陷跟踪、社交化协作、多层次事务看板、多维度统计报表等功能。敏捷交付：采用敏捷流程进行产品开发的团队，通过软件开发云项目管理，进行迭代计划制定、需求分析、任务分解、缺陷跟踪，高效协作开发产品。外包协作：外包项目发包方和接包方基于软件开发云项目管理的同一个外包项目，进行协同开发与交付。发包方在项目中提出需求，并跟踪项目进展，完成产品验收。接包方进行需求分析、开发、交付与问题修复。通过软件开发云项目管理，双方实现无缝、实时对接，确保项目交付准确度和高质量。
什么是SPU？	流处理单元，简称SPU，是CloudStream计费单位。1个SPU的标准配置为1核的CPU、4G的内存。用户作业可以设置多个SPU。
文件系统访问权限怎么控制？	文件系统仅可被同一VPC下云服务器共享使用。当云服务器挂载该文件系统，即可实现文件共享，并阻止其他VPC下的云服务器访问。
云硬盘容量可以变更吗	云硬盘当前阶段只支持扩容，不支持减容。
如何使用华为云提供的CentOS镜像源？	操作场景用户需要更新弹性云服务器的系统或者软件时，可以连接Internet，通过外部CentOS镜像源提供相关服务。但是，如果弹性云服务器无法访问Internet，或者外部CentOS镜像源提供的服务不稳定时，可以使用华为云提供的CentOS镜像源进行更新。
订阅终端地址可以修改吗？	订阅终端地址不允许修改。如果需要更换某个主题下的订阅终端地址，可删除原有的订阅终端，重新在该主题下选择订阅协议并输入对应的订阅终端。
我要如何获取磁盘签名文件？	请登录DESConsole，单击待寄送磁盘的服务单后的下载磁盘签名文件，将磁盘签名文件下载到本地。
什么是低危、中危、高危漏洞？	漏洞等级采用CVSS2标准的评分原则，对单个漏洞进行基本向量评分。CVSS，即通用漏洞评分系统，是一个行业公开标准，其被设计用来评测漏洞的严重程度，并帮助确定所需反应的紧急度和重要度。CVSS系统对所有漏洞按照从0至10的级别进行评分，其中，10表示最高安全风险。在CVSS系统中获得0至3的分数的低危漏洞仅可能被本地利用且需要认证。成功的攻击者很难或无法访问不受限制的信息、无法破坏或损坏信息且无法制造任何系统中断。示例包括默认或可推测的SNMP社区名称以及OpenSSLPRNG内部状态发现漏洞。在CVSS系统中获得4至6的分数的中危漏洞可被拥有中级入侵经验者利用，且不一定需要认证。成功的攻击者可以部分访问受限制的信息、可以破坏部分信息且可以禁用网络中的个体目标系统。示例包括允许匿名FTP可写入和弱LAN管理器散列。在CVSS系统中获得7至10的分数的高危漏洞可被轻易访问利用，且几乎不需要认证。成功的攻击者可以访问机密信息、可以破坏或删除数据且可以制造系统中断。示例包括匿名用户可以获取Windows密码策略。
CCE应用部署失败的可能原因?	应用部署失败的可能原因有以下几点：应用所需资源超过集群可用资源。使用的Docker版本为1，如果您使用的镜像不兼容Docker1，则会导致应用部署失败。应用模板中配置的镜像地址有误，导致无法下载镜像。集群所在的VPC安全组未添加可访问外部的出方向规则，导致无法下载镜像。关于为安全组添加安全组规则可参考帮助中心虚拟私有云用户指南快速入门配置无需访问公网的弹性云服务器的VPC为安全组添加安全组规则应用部署在集群上，该集群所在VPC子网的DNS地址配置有误，导致无法下载镜像。关于修改子网网络信息可参考帮助中心虚拟私有云用户指南管理修改子网网络信息
什么是安全公司？	安全公司是执行渗透测试的第三方公司，测试人员都是寻找网络系统安全漏洞的专业人士。
分布式缓存服务支持数据持久化吗？	单机：不支持。主备：支持。
为什么创建裸金属服务器的任务失败，但是在服务器列表中显示创建成功？	问题描述在弹性IP资源不足的情况下，用户通过管理控制台创建一台绑定弹性IP的裸金属服务器，此时裸金属服务器创建成功，但是绑定弹性IP失败。这种情况下，裸金属服务器申请状态栏显示任务失败，但裸金属服务器列表页面显示服务器创建成功。
什么是可用分区？	可用分区是同一服务区内，电力和网络互相独立的地理区域，一般是一个独立的物理机房，这样可以保证可用分区的独立性。一个地域内有多个可用分区，一个可用分区发生故障后不会影响同一地域内下的其它可用分区，可用分区间通过内网访问。
用户申请的RDS实例磁盘空间会有哪些系统开销	您申请的磁盘空间会有必要的文件系统开销，这些开销主要包括inode、reservedblock，以及数据库运行必需的空间。
为什么使用密钥文件无法正常登录云服务器？	问题描述用户使用密钥文件登录弹性伸缩组中的云服务器时，登录失败。
如何基于通信平台云进行二次开发？	二次开发指导请参见如何基于通信平台云进行二次开发
代码检查各角色类型对应的操作权限是什么？	代码检查中用户的角色类型及对应的操作权限说明，如表1所示。表1角色类型及操作权限角色操作代码检查任务检查规则集问题列表消息通知项目创建者创建、删除、执行、查看代码检查任务
是否支持修改CDN加速的业务类型？	不支持。
会话保持如何开启？	在您的负载均衡服务监听器创建成功时会话保持就默认打开。在监听器生命周期内全程开启。如果会话保持是关闭状态，请在监听器里表中选择需要开启会话保持的监听器，单击操作栏下的修改，在弹出的修改监听器对话框中将会话保持开关打开。
如何将非加密镜像修改为加密镜像？	如果用户需要将原来某个非加密的镜像采用加密方式进行保存，则可以通过镜像复制功能，指定加密密钥，将原有的非加密镜像复制为新的一个加密私有镜像。
弹性伸缩是否会因监控指标突变导致误伸缩？	不会。弹性伸缩服务的监控数据基于云监控服务来获取的，监控周期可配置多个档位，如：五分钟，二十分钟，一小时等。不会因为一次指标的高峰而导致错误伸缩。同时，弹性伸缩服务还支持配置冷却时间，防止由于监控的变化造成伸缩组的反复无效变化。该时间可由用户进行自定义。
安全指数服务提示为高风险时，该如何处理？	首先，需要确认页面上方的几个评分圈的闭合程度，闭合程度越高越安全。例如，图1中通过闭合度比较，可以看出左侧评分圈较不安全，右侧评分圈较安全。图1评分圈闭合度对比点击放大
如何处理支付订单后云服务器开通失败？	用户支付订单后，如果收到云服务器开通失败的短信，请致电华为云客服中心电话4000，客服会协助用户排除故障，开通云服务器。如果故障无法及时排除，用户可以选择取消订单，客服会做退费处理，将订单费用退还至用户的公有云账户。
客户端状态异常应该怎么处理？	用户通过登录管理控制台，选择安全合作伙伴产品中心主机入侵检测，进入页面查看主机入侵检测客户端的运行状态。当主机检测状态异常时，表明已成功安装客户端，并且开启了入侵检测服务，但客户端与服务器间通信异常。可能的原因：网络故障，或者是客户端进程异常。处理方法：由于网络故障导致的异常，在网络恢复正常后客户端状态会自动更新为正常，不需要人为处理。如果长时间客户端状态异常，需要登录弹性云服务器，重启或重新安装客户端。
华为云迁移都有什么解决方案可选？	应用级业务迁移：使用专门的应用层迁移工具，在保证可用性前提下，从应用程序层面，将数据从旧系统迁移到新系统，满足用户迁移同时，完成对操作系统、数据库软件的升级。例如：Oracle和SQLSERVER的在线迁移。文件级业务迁移：根据用户的需要，通过迁移工具，将用户的工作负载以基于文件系统的方式，从源主机迁移到目标主机，以满足用户对磁盘规格的重规划、操作系统的升级。系统级业务迁移：在用户的一台主机上运行了大量应用，可以通过迁移工具将主机硬件以上的系统迁移到目标虚拟机上，包括操作系统、应用程序和配置数据，主要用于系统盘的迁移。
消息通知服务的使用如何收费和计费？	我们提供免费配额，超出部分按需收费。
云专线接入的地址如何规划？	云专线接入两端的IP地址不能冲突，而且必须是私有地址，如果用户端网络全部是公有地址，则需要客户端自己做NAT映射。
使用DES服务邮寄的磁盘有什么要求？	一个服务单只能包含一块磁盘，且一块磁盘只包含一个分区。当前支持的磁盘规格：SATA2英寸、SATA3英寸和SAS3英寸。当前支持的磁盘接口类型：USB2、UDS3、SATA、SAS。当前支持的文件系统类型有：EXT2、EXT3、EXT4、FAT32、EXFAT。
是否支持退费？	暂时不支持自动退费。
怎么解决查询运行缓慢的问题	通过查看慢SQL日志来确定是否存在运行缓慢的SQL查询以及各个查询的性能特征如果有，从而定位查询运行缓慢的原因。查询MySQL日志，请参见慢查询日志查询PostgreSQL日志，请参见查看近期日志可以通过查询DMV视图，从而定位查询运行缓慢的原因，有关使用DMV的信息，请参官网信息查看RDS实例的CPU使用率指标，协助定位问题。请参见通过CES监控
如何使用Git的常用命令？	是一款免费、开源的分布式版本控制系统，用于敏捷高效地处理任何或大或小的项目，能有效高速地处理从很小到非常大的项目版本管理。通过Git可以从服务器克隆完整的Git仓库包括代码和版本信息到单机上，然后根据不同开发目的灵活创建分支、修改代码、提交代码、合并分支等。常用命令常用命令的功能、格式、参数说明以及使用实例如表1所示。表1常用命令命令功能格式参数说明使用实例克隆远程仓库。：版本库的网址。克隆的版本库：该命令会在本地主机生成一个目录，与远程主机的版本库同名。把远程仓库的分支pull到本地，再与本地的指定分支合并。命令格式说明取回主机的分支，与本地的分支合并：添加文件到暂存区。：文件名添加一个文件到暂缓区：添加所有修改的和新增的文件到暂缓区：文件、分支、目录或版本的比较。当前与分支的比较：文件提交。添加提交信息：推送文件到远程仓库。命令格式说明如果省略远程分支名，则表示将本地分支推送与之存在追踪关系的远程分支通常两者同名，如果该远程分支不存在，则会被新建：上面命令表示，将本地的分支推送到主机的分支。如果后者不存在，则会被新建。新建分支。：新的分支名产生新的分支：合并分支。：分支名假设当前分支为，将主分支之后的最新提交到当前的分支上：切换分支。：分支名切换到分支：列出日志信息。列出所有的查看状态输出。删除本地目录或文件。：文件名或目录名删除文件：查找字符串。查找是否有字符串：显示内容或修改的内容。显示的修改内容显示当前版本的修改文件显示前一版本所有的修改文件显示前4版本的修改文件
什么是碎片？	什么是碎片？显示碎片管理什么是碎片？什么是碎片？桶中不完整的数据称之为碎片，通常是由于数据上传失败而产生的。
云容器引擎与其他服务之间的关系？	弹性云服务器弹性云服务器是由CPU、内存、镜像、云硬盘组成的一种可随时获取、弹性可扩展的计算服务器，同时它结合虚拟私有云、虚拟防火墙、数据多副本保存等能力，为您打造一个高效、可靠、安全的计算环境，确保您的服务持久稳定运行。在云容器引擎中一个节点就是一台弹性云服务器和两块云硬盘，您可以在创建节点时指定弹性云服务器的规格。云硬盘可以将云硬盘挂载到云服务器，并可以随时扩容云硬盘容量。在云容器引擎中一个节点就是一台弹性云服务器和两块云硬盘，您可以在创建节点时指定云硬盘的大小。虚拟私有云为弹性云服务器提供一个逻辑上完全隔离的专有网络，您还可以在VPC中定义安全组、VPN、IP地址段、带宽等网络特性。用户可以通过VPC方便地管理、配置内部网络，进行安全、快捷的网络变更。同时，用户可以自定义安全组内与组间弹性云服务器的访问规则，加强弹性云服务器的安全保护。在云容器引擎中创建的集群需要运行在虚拟私有云中，从而保障网络安全。弹性负载均衡云容器引擎支持将创建的应用对接到弹性负载均衡，从而提高应用系统对外的服务能力，提高应用程序容错能力。对象存储服务对象存储服务是一个基于对象的海量存储服务，为客户提供海量、安全、高可靠、低成本的数据存储能力，包括：创建、修改、删除桶，上传、下载、删除对象等。云容器引擎使用对象存储服务存储用户上传的私有镜像。云审计服务云审计服务，为您提供云服务资源的审计操作记录，审计信息包括时间、资源对象、资源ID、请求源IP和开放API发起的云服务资源操作请求以及每次响应的结果，供您查询、审计和回溯使用。当前CTS记录CCE的操作有：资源的创建资源的更新资源的删除说明：资源包括集群、节点、应用、图形化编排和容器镜像。
哪些用户应该开通云审计服务？	具有如下需求的用户可以开通云审计服务：需要执行安全分析。需要排查故障定位问题。需要追踪资源变更情况。
DDS支持读写分离吗	支持读写分离，它的写操作仅可以在复本集中的主节点上进行，用户通过配置实现读操作在从节点进行。
RDS支持导入哪些数据库引擎的数据	相同引擎数据库之间数据导入导出，称之为同构型数据库之间数据导入导出。不同引擎数据库之间数据导入导出，称之为异构型数据库之间数据导入导出。例如，从Oracle导入数据到RDS支持的数据库引擎。异构型数据库之间由于格式不同，不支持直接导入导出。但只要导入导出的格式数据兼容，理论上，导入表数据也是可行的。异构型数据库之间数据导入导出，一般需要第三方软件，通过数据复制的方式来实现。比如，先使用工具从Oracle中，以文本的格式导出表记录，然后利用Load语句导入到RDS支持的数据库引擎。
数据存储在DIS和OBS有什么区别？	开通实例时需要选择输出类型，选择表示DIS存储，选择表示存储在DIS中，并周期性导入OBS。两者具体区别如表1所示。表1和OBS区别存储存储服务自带。需要另外申请。无需另外付费。需要根据OBS收费标准另外付费。临时存储最长保留24小时永久存储。只存储在DIS中。存储在DIS中，并周期性导入OBS。
申请开通弹性云服务器需要多久？	通常几分钟之内即可开通成功。具体的，与该弹性云服务器的规格、配置资源如云硬盘、弹性IP，以及当前的系统负载有关。
缓存实例的数据被删除之后，能否找回？	缓存实例自行删除或者通过Redis客户端发送命令手动删除的数据，不能找回。DCS的默认数据逐出策略为不逐出，但用户可以通过修改实例配置参数，自行调整策略，由实例根据逐出策略回收键值。缓存实例整个被删除后，实例数据也将丢失，不能找回。删除实例应当谨慎。主备缓存实例支持实例数据备份，如果实例有数据备份，则可以通过恢复实例完成数据找回。
为什么在事件列表中按照操作用户进行筛选时，存在user_account/op_service用户？	用户？当用户发起的某些请求涉及后台一些高权限要求的操作或涉及调用其他服务时，可能存在用户自身的权限不足的问题，因此在确保符合安全要求的前提下，会临时对该请求中的用户身份进行提权，请求完成后提权结束，但会将提权行为记录到该请求发送到CTS的日志当中，此时的操作用户将记录为user
什么是CU	指计算单元，即资源的容量单位，比如一个资源包含若干CU。，即1CU表示4核，16GB内存的计算资源。
复本集中主备同步存在多长时间的延迟	主节点与备节点的复制延迟是无法利用公式来计算的，它会受到以下因素的影响：网络通信状况。主节点的事务压力，即主机每秒执行的事务量。主节点执行的事务大小，即一个事务要执行多久。备节点的机器负载状况。如果主节点在某个时间段压力非常大，每秒执行的事务量非常多，备机通常会出现延迟。对于而言，可以在CES中查看备节点的主备延时指标，来观察延迟情况。
通过控制台可以修改哪些参数项（MicrosoftSQLServer）	允许通过控制台修改的参数项如表1说明：系统提供的默认参数组不允许修改，只可单击操作列中的查看进行查看。当用户参数设置不合理导致数据库无法启动时，可参考默认参数组重新配置。
云报表服务不支持哪些数据库数据分析？	基于对用户数据安全性考虑，云报表服务不支持对如下MySQL数据库进行数据预览或分析：
多个用户是否可以共享一对AK和SK来访问OBS？	多个用户是否可以共享一对AK和SK来访问OBS？显示安全性多个用户是否可以共享一对AK和SK来访问OBS？多个用户是否可以共享一对AK和SK来访问OBS？可以，AK与SK是用户访问OBS时需要使用的密钥对。不同的用户使用相同的一对AK和SK可以同时访问OBS中的资源，且访问到的资源相同。
部署管理各角色类型对应的操作权限是什么？	部署管理中用户的角色类型及对应的操作权限说明，如表1所示。表1角色类型及操作权限角色操作授信机器挂靠主机组授信机器未挂靠主机组主机组部署模板部署任务通知项目创建者全部权限：添加、修改、删除、查看授信机器创建、查看授信机器修改、删除自己的授信机器
操作系统自带FTP上传吗？	需要用户自己安装和配置。
什么是私网弹性负载均衡	私网弹性负载均衡是支持同一个虚拟私有云下的云服务器之间互相访问的负载均衡功能。同一个虚拟私有云下的云服务器通过访问私网弹性负载均衡的服务IP和端口来将负载分发到后端云服务器上。
一个帐号最多可以创建多少个私有镜像？	在当前阶段，您在一个区域内默认最多可以创建10个私有镜像。如果您需要创建更多的私有镜像，可以通过提交工单的方式，申请扩大配额上限。
M	多维交互分析服务，简称M，是一种新型的ApacheHadoop本地文件格式。通过采用列式存储、索引、压缩和编码技术，提高计算效率，实现PB数量级的数据交互查询。M也是一种将数据源和Spark集成的高性能分析引擎。
弹性云服务器在什么时候进入开通状态？	包年包月的弹性云服务器：当您支付完费用且系统扣款成功后，将自动为您开通弹性云服务器。按需的弹性云服务器：由于是先使用后付费，所以确认创建后就进入开通状态。
我的数据通过DES传输，如何保证安全性？	支持使用第三方加密工具Truecrypt对数据进行加密，邮寄加密后的数据可确保数据在寄送途中的安全。华为数据中心管理员在接收到磁盘并挂载后，需要由用户自己输入AK和加密密钥触发数据自动上传，华为人员全程不接触和密钥和用户数据，确保数据的安全。通过DES传输的数据最终存放在对象存储服务OBS中，OBS服务支持SSL加密、ACL权限控制、桶策略等安全保障机制，且数据分片随机存储在不同硬盘上，保障数据的存储、访问安全。
RDS有哪些安全保障措施	网络可以设置所属VPC，从而确保RDS实例与其他业务实现网络安全隔离。使用安全组确保访问源为可信的。使用SSL通道，确保数据传输加密。数据库实例数据库配置了防暴力破解功能。
云服务器备份服务支持对弹性云服务器中所有云硬盘进行备份吗？	支持。云服务器备份服务可以通过创建备份策略并绑定云服务器，将云服务器中的所有云硬盘作为整体进行备份和恢复，不支持对云服务器中的部分云硬盘进行备份和恢复。
如何使用联络中心服务？	您需要有座席客户端才能使用联络中心的服务。座席客户端有两种获取方式：获取座席Demo，该Demo不能正式商用，仅用于测试和体验。基于华为接口开发座席客户端。图1使用联络中心服务点击放大
邮寄磁盘的费用由谁来承担？	您需要将磁盘邮寄至华为数据中心由DES帮您完成数据传输，该邮寄费用需要您来承担。当数据传输完成后，华为数据中心将会采取邮费到付的方式将磁盘回邮给您，该邮费也需要由您来承担。
机器学习服务可以做什么？	机器学习服务应用于海量数据挖掘分析场景。市场分析商场从顾客消费记录中找出某类顾客群的共有特征兴趣、收入水平和消费习惯等，分析出什么样的顾客买什么产品，从而调整市场策略。定向推荐银行从客户的个人财务状况信息中分析客户特征，定向推荐合适的产品贷款项目、理财产品，以小代价获取大收益。欺骗检测保险公司分析投保人的历史行为数据，建立欺骗行为模型，识别出假造事故骗取保险赔偿的投保人。
什么是CloudStream？	实时流计算服务，简称Stream，是运行在华为云上的实时流式大数据分析服务，全托管的方式用户无需感知集群的存在，只需聚焦于StreamSQL，即时执行作业，完全兼容Flink。为用户打造了一个易使用、高安全、高可靠的运行维护平台，是华为公司在IT领域主推的低时延级时延、高吞吐、高可靠的分布式实时流计算服务。它以Flink为核心，孵化一些Flink上的特性，是一个批处理和流处理结合的分布式计算框架，提供了数据分发以及并行化计算的流数据处理能力，适用于实时性要求高、吞吐大的业务场景。
攻击和弱点列表记录哪些信息，可以删除吗？	攻击列表记录：攻击ID，攻击时间，攻击源，攻击类型，事件详情，攻击者ID，攻击目标。最多记录最近一周内的事件，不可删除。弱点列表记录：弱点ID，告警时间，弱点类型，告警详情，目标实例。最多记录最近一周内的弱点，不可删除。
跨域资源共享	显示跨域资源共享跨域资源共享
编译构建各角色类型对应的操作权限是什么？	编译构建中用户的角色类型及对应的操作权限说明，如表1所示。表1角色类型及操作权限角色操作编译构建任务通知项目创建者创建、修改、删除、执行、禁用、搜索、查看编译构建任务下载编译构建包查看任务执行报告历史获取构建任务的代码仓库地址
登录会议管理控制台，提示该区域不支持所选服务怎么办？	会议管理控制台，提示该区域不支持所选服务怎么办？华为云会议目前仅针对中国华北区1开通服务。如您登录会议管理控制台，提示该区域不支持所选服务，可能是在此之前您手动切换过默认区域。直接在提示页面单击中国华北区1，切换默认区域为中国华北区1，如图1所示。图1切换默认区域
计费	问：对于创建节点失败期间回滚的资源，我是否需要付费？是。无论节点是否创建成功，创建节点期间使用的云服务器资源均需收费，该过程会根据公有云服务器的统一收费策略来收取费用。
为什么创建弹性云服务器的任务失败，但是在云服务器列表中显示创建成功？	问题描述在弹性IP资源不足的情况下，用户通过管理控制台创建一台绑定弹性IP的弹性云服务器，此时弹性云服务器创建成功，但是绑定弹性IP失败。这种情况下，弹性云服务器申请状态栏显示任务失败，但弹性云服务器列表页面显示云服务器创建成功。
MSTSC方式登录Windows2012的弹性云服务器，登录失败怎么办？	问题描述对于密码鉴权方式创建的Windows2012弹性云服务器，使用初始密码以MSTSC方式登录时，登录失败，系统显示第一次登录之前，你必须更改密码。请更新密码，或者与系统管理员或技术支持联系
哪些用户有权限使用加密特性	对于一个用户组的用户，加密特性使用权限的规则如下：拥有SecurityAdministrator权限的用户可以直接授权EVS访问KMS，使用加密特性。普通用户即没有SecurityAdministrator权限的用户使用加密特性时，根据该普通用户是否为用户组内第一个使用加密特性的用户，作如下区分：是，即该普通用户是用户组内第一个使用加密特性的，需先联系拥有SecurityAdministrator权限的用户增加权限，然后再使用加密特性。否，即用户组内的其他用户已经使用过加密特性，该普通用户有权限直接使用加密特性。下面，我们以一个用户组为例，介绍授权EVS访问KMS时的用户权限问题。假设该用户组有4个用户用户1用户4，其中，用户1拥有权限，其他三个用户为普通用户，没有权限，如图1所示。图1用户组
堆栈、编排、模板、设计包分别是什么？	详细概念请参照表1表1编排基本概念概念概念说明编排编排是指对组成堆栈的元素按照一定的次序进行处理的过程。通过定义应用组件、对资源的需求、依赖的服务、元素之间的关系拓扑等，完整地描述应用本身以及所依赖的服务、资源，最后交由ServiceStage平台完成部署。设计包运维人员对应用的拓扑、生命周期管理计划进行设计，并输出应用模板也可称为应用设计包设计器还提供了图形化设计器工具，用户可通过拖拽方式完成复杂应用的编排及拓扑设计，可以保存成模板，使用模板创建堆栈，简化应用部署难度，提升效率。模板模板是对堆栈的描述，包括基于应用模型的堆栈拓扑定义、堆栈生命周期描述、运行时资源描述、软件组件描述等。模板通过设计包创建而来，本质与设计包相同。堆栈由应用、服务、资源等元素组成的一个部署实例，平台将相关编排元素通过堆栈进行集中管理。
OBS系统中会不会残留垃圾数据？	系统中会不会残留垃圾数据？显示碎片管理系统中会不会残留垃圾数据？系统中会不会残留垃圾数据？会，OBS采用分块上传的模式上传数据，在下列情况下但不仅限于此通常会导致数据上传失败而产生垃圾数据。网络条件较差，与OBS的服务器之间的连接经常断开。上传过程中，人为中断上传任务。设备故障。突然断电等特殊情况。
调用AIS的API失败时怎么处理？	检查原因根据API调用返回结果或者错误码查找原因。检查访问密钥AK是否获取成功。检查Token是否填写正确或者已过期。检查API调用方法是否正确。
CloudStream支持输出到哪些目标？	支持将作业的结果数据输出到数据接入服务上和关系型数据库
支持哪些接口类型的云专线？	支持千兆电口和万兆光口连接。
开发者Portal对浏览器的要求	消息短信服务的开发者Portal仅支持使用以下浏览器登录：及以上版本浏览器及以上版本浏览器
如何登录软件开发云？	登录软件开发云分为两种情况：注册账号登录和管理员创建的用户登录。两种情况登录方式分别如下：说明：注册账号为注册的企业用户，管理员创建的用户为企业用户下的用户即企业用户自己创建的用户
什么是RDS实例可用性	实例可用性的计算公式：实例可用性故障时间服务总时间
如何使用通信平台云服务？	通信平台云提供了语音、视频、协作等基础资源服务能力，我们提供了丰富的SDK接口，您可以使用我们提供的组件SDK，在您的用户程序中调用SDK的接口访问通信平台云服务。二次开发指导请参见如何基于通信平台云进行二次开发
分布式消息服务是否提供“至少一次”的消息交付功能？	至少一次的消息交付功能？是的。分布式消息服务会在多台服务器上存储消息的副本，以实现冗余和高可用性。在极少数情况下，当您接收或删除消息时，存储消息副本的服务器之一可能不可用。如果出现这种情况，则该不可用服务器上的消息副本将不会被删除，并且您在接收消息时可能会再次获得该消息副本。这被称为至少一次交付。因此，您必须将您的应用程序设计为幂等的应用程序即，如果您的应用程序多次处理同一条消息，则不得受到不利影响
什么是服务？	服务定义了实例以及访问实例的途径，比如单个稳定的IP地址和相应的DNS名称。在创建应用时会指定服务名称。服务的类型有三种，分别是InternalService、NodePort、LoadBalancer。类型的服务只能在集群内部访问。、LoadBalancer类型的服务支持从内部和外部访问。
申请开通裸金属服务器需要多久？	通常在72小时之内开通成功。
我可以在OBS中存储多少数据？	我可以在OBS中存储多少数据？显示一般性问题我可以在OBS中存储多少数据？我可以在OBS中存储多少数据？系统和单个桶都没有总数据容量和对象文件数量的限制。
能否在函数代码中使用线程和进程？	用户可使用编程语言和操作系统的功能，在函数中创建额外的线程和进程。
相关配置是否有相对合理的推荐值?	于健康检查的参数配置，提供如下参考建议。间隔时间：2秒，间隔时间为健康检查每次检查的时间间隔。超时时间：5秒，超时时间为健康检查等待时间。健康阈值：3，健康阈值为健康检查的连续变化次数。不健康阈值：3，不健康阈值为不健康检查的连续变化次数。在此配置下有利于用户服务及应用状态的尽快收敛。云服务器健康检查失败响应时间：2如果用户有更高要求，可以适当地降低响应超时时间值，但必须先保证自己服务在正常状态下的处理时间小于这个值。云服务器健康检查成功响应时间：2
RDS数据库实例支持的最大数据连接数是多少	对此未做限制，取决于数据库引擎参数的默认值和取值范围，例如MySQL引擎的max和max参数，用户可在参数组自定义。
CCE服务常见的使用场景有哪些？	服务常见的使用场景如下：适用于传统IT架构渐进式转型的场景，实现单一架构解耦拆分为多个容器，系统更灵活，轻松应对市场变化。适用于业务上线效率低下的场景，实现容器镜像贯穿从开发到运维各环节，统一环境配置，业务快速上线。适用于访问量有明显波峰、波谷的应用，实现自动弹性伸缩，系统秒级自动弹性扩容，快速响应并发高峰。适用于系统IT资源浪费严重的场景，使平均负载维持较高水平，每分钱都真正支持业务。适用于复杂系统运维压力大的场景，基于容器服务实现自动化运维，基于实时日志快速问题定位，界面化操作和短信通知实现24小时自动监控。
导入成员后页面没有反应怎么办	导入成员后，页面可能无法立即显示导入结果，您可以刷新页面后查看。
如何使用流水线？	流水线提供可视化、可定制的自动交付流水线，帮助企业缩短交付周期，提升交付效率。
共享文档时，文档很长时间才显示出来	共享文档时，会弹出一个正在打印的提示，文档很长时间才显示出来。文档共享是将文档打印后再共享的，打印过程是调用操作系统的打印接口完成，弹出正在打印提示属于正常现象，客户端程序控制不了。如果文件比较大，打印可能耗时较长，导致文档很长时间才显示出来，可搜索如下日志来确定打印用的时间。
连接分布式缓存服务必须使用密码吗？如何获取密码？	本身支持不设置密码，客户端可以直接连接Redis缓存服务并使用。出于安全考虑，客户端连接缓存实例必须通过密码来鉴权验证。您需要在创建缓存实例时自定义密码。分布式缓存服务处于运行中状态的缓存实例支持修改密码，集群实例暂不支持修改密码。
对象存储与SAN存储和NAS存储相比较有什么优势？	对象存储与SAN存储和NAS存储相比较有什么优势？显示一般性问题对象存储与SAN存储和NAS存储相比较有什么优势？对象存储与SAN存储和NAS存储相比较有什么优势？存储提供给应用的是一个LUN或者是一个卷，LUN和卷是面向磁盘空间的一种组织方式，上层应用要通过FC或者ISCSI协议访问SAN。SAN存储处理的是管理磁盘的问题，其它事情都要依靠上层的应用程序实现。存储提供给应用的是一个文件系统或者是一个文件夹，上层应用通过NFS和CIFS协议进行访问。文件系统要维护一个目录树。对象存储更加适合web类应用，基于URL访问地址提供一个海量的桶存储空间，能够存储各种类型的文件对象，对象存储是一个扁平架构，无需维护复杂的文件目录。无需考虑存储空间的限制，一个桶支持近乎无限大的存储空间。
我申请裸金属服务器可以和同VPC内的弹性云服务器通信吗？	可以。您创建的VPC，可能存在多个网段，裸金属服务器和弹性云服务器在同一个网段时进行二层通信，在不同网段时进行三层通信。此外，与弹性云服务器通信时必须配置安全组规则。由于裸金属服务器暂不支持安全组配置，所以只需在与弹性云服务器关联的安全组中配置相应的规则，对裸金属服务器IP进行放通操作。
弹性负载均衡是否可以添加不同操作系统的云服务器？	可以。本身不会限制后端的云服务器使用哪种操作系统，只要您的2台云服务器中的应用服务部署是相同且保证数据的一致性即可。但是，我们建议您选择2台相同操作系统的云服务器进行配置，以便您日后的管理维护。
重装操作系统是否需要收费？	重装操作系统提供以原镜像进行系统重装的功能，不会收取额外费用。
RDS能够保存多长时间的备份	自动快照有效期根据用户设置的备份天数而定。备份空间不占用用户购买的数据库空间。快照没有时间限制，且用户可根据需要进行删除。每个租户手动快照总配额默认为50。
DDS有哪些安全保障措施	可设置所属VPC，从而确保实例与其它业务实现网络安全隔离。另外，通过统一身份认证服务，以下简称IAM，可以实现对资源的访问权限控制。
如何获取会议设备的设备序列号？	会议设备的设备序列号？会议设备的设备序列号是唯一标识设备的字符串，用以保证将License授权给指定设备的关键，又称设备指纹。使用会议设备前，需要在云视频会议管理控制台上创建会议设备，填写会议设备的设备序列号。登录会议设备的Web界面，选择帮助版本，在弹出的版本页面可以查看会议设备的设备序列号。包装盒或会议设备背面贴有的SN条码纸上也可以查询会议设备的设备序列号。
什么是密钥管理服务？	密钥管理服务，即KMS，是一种安全、可靠、简单易用的密钥托管服务，帮助用户集中管理密钥，保护密钥安全。通过使用硬件安全模块HSM保护密钥安全，帮助用户轻松创建和管理密钥，所有的用户密钥都由HSM中的根密钥保护，避免密钥泄露。KMS对密钥的所有操作都会进行访问控制及日志跟踪，提供所有密钥的使用记录，满足审计和合规性要求。
什么是OBS的事件通知？	什么是OBS的事件通知？显示事件什么是OBS的事件通知？什么是OBS的事件通知？您可以通过事件通知发送警报或触发工作流，并通过消息通知服务：SimpleMessageNotification发送通知。
云硬盘规格是什么	云硬盘可满足大容量存储需求。系统盘容量范围为1GB，数据盘容量范围为10GB
如何使用配置管理？	配置管理提供云端代码托管功能，即支持代码仓库创建克隆、一键式下载上传代码等功能。用户可以快速导入代码库，在云端生成一个基础工程；用户通过IDE插件将云端工程代码一键下载到本地进行功能开发，开发完毕后将变更的代码一键上传到云端。
什么是Pipeline?	是由一系列的activities，DataSource互相关联构成，其中activity表示对数据的处理操作，DataSource表示数据来源和存放位置。相关联的activities表示前一个activity执行完毕后，下一个activity才能开始执行。
云解析服务是否计费？	不收费。
为什么用户接收到的邮件中图片无法显示？	部分邮箱为帮助保护您的隐私，默认禁止自动从Internet下载图片，导致邮件中图片无法显示，您需要在您的邮箱中设置允许自动下载图片即可正常显示图片。
为什么有时报关遵从检测的结果会不准确？	报关遵从检测不准确时识别出异常点过多或异常点过少，有以下几个原因：输入数据质量太差。算法默认异常点是小概率出现的，如果输入数据中异常点的比例过高，会造成算法失效。参数设置不合理。参数说明请参见人工智能服务接口参考如果有错误码。错误码具体说明请参见人工智能服务接口参考
删除RDS集群后数据库备份会怎样	和PostgreSQL引擎，根据该集群中是否有可用手动快照来决定：有，保留该集群上现有手动快照，删除集群并释放所有资源。无，跳转到快照管理页面，进行最后一次手动快照创建。引擎，如果集群中有手动快照，保留现有手动快照，其他所有资源被释放。说明：引擎目前不支持恢复到新数据库实例，所以，保留的手动快照暂不可用。
为什么智能装车效果较差？	智能装车效果较差时，有以下几个原因：箱子类型较多。算法考虑的约束条件较多，在箱子类型较多时效果可能不如预期，建议将箱子类型进行筛选。参数设置不合理。算法对参数约束条件较多，需严格按照参数说明输入，具体请参见人工智能服务接口参考
使用HTTP/HTTPS协议有什么注意事项？	协议有什么注意事项？使用HTTP或者HTTPS协议上传文件时，文件的大小不能超过10M。如果超过10M，建议使用TCP协议。
什么是生命周期管理？	什么是生命周期管理？显示生命周期管理什么是生命周期管理？什么是生命周期管理？生命周期管理是指通过配置指定的规则，实现定时删除桶中的对象。
为什么重置密码后新密码没有生效	可能原因密码重置发生在备份操作之后，执行恢复操作时，恢复为旧密码。
一个SSL证书能够绑定几个域名？	目前证书管理服务只提供免费版的DVSSL证书，一个证书只能绑定一个域名。
MRS当前支持哪些组件？	当前支持Hadoop、Spark、HBase和Hive组件，后续会支持更多版本和组件。组件在MRSManager中也被称为服务。
支付成功后为什么不能马上看到创建中的弹性云服务器？	在创建弹性云服务器时，由于系统盘的创建需要少许时间，所以等系统盘创建出来后即可看到创建中的弹性云服务器。
云报表服务是否收费？	公测期间免费。
如何使用Anti	为实例IP地址开启Anti后，即可正常使用。登录管理控制台。选择安全流量清洗，进入Anti服务管理界面。实例列表界面，在待开启防护的实例IP地址所在行，单击开启防护，如图1所示。图1开启防护点击放大
云服务器备份时，需要停止弹性云服务器吗？	不需要，云服务器备份服务支持对正在使用的云服务器进行备份。在云服务器正常运行的情况下，除了将数据写入云硬盘外，还有一部分最新数据保存在内存中作为缓存数据。在做备份时，内存缓存数据不会自动写入云硬盘，会产生数据一致性问题。因此，为了尽量保证备份数据的完整性，最好选择凌晨且云硬盘没有写入数据的时间进行云服务器备份；或者在进行云服务器备份前，暂停所有数据的写操作，且将应用系统停止，再进行备份。如果对备份数据完整性要求极高，则可以将云服务器停机实现缓存数据写入云硬盘，进行离线的云服务器备份。
使用DDS要注意什么	故障切换实例采用多路由多分片复本集的部署形态，当路由主机出现故障时，可实时动态切换。复本集包含多个副本，当主节点发生故障时，会在30秒之内切换到备节点。实例的弹性云服务器，以下简称ECS，对用户都不可见，这意味着，只允许用户应用程序访问数据库对应的IP地址和端口。使用的对象存储服务，以下简称OBS上的备份文件，对用户不可见，它们只对后台管理系统可见。申请后，您还需要做什么：您不需要进行数据库的基础运维比如高可用、安全补丁等，但是您还需要重点关注以下事情：实例的CPU、IOPS、空间是否足够，如果不够需要优化或者扩容。实例是否存在性能问题，是否有大量的慢查询，查询语句是否需要优化，是否有多余的索引或者索引缺失等。
如何使用项目版本计划管理？	项目管理提供迭代功能，可以用来做版本计划管理，用户在项目里新建迭代，匹配版本发布计划时间点，便可对版本计划进行跟踪管理。
服务端问题导致连接失败	服务端可能出现的问题如下，请依次进行检测。连接方式有误。解决方法：检查连接方式。ECS与RDS实例必须处于同一VPC内，且只能通过ECS连接。连接数满。解决方法：通过RDS的资源监控功能查看连接数、CPU使用率等指标是否正常，如果达到上限，需要进行重启RDS实例数据库、断开实例连接或升级RDS实例规格解决。实例状态异常，比如实例重启卡住，RDS系统故障，实例或表被锁定等。解决方法：尝试重启功能。如果无法解决，请联系售后技术支持。
是否支持集群扩容？	服务当前支持扩容，扩容后将增加集群节点以提升计算和存储能力。
事件列表用于记录哪些信息？	事件列表记录了云账户中对云服务资源新建、配置、删除等操作的详细信息。事件列表不记录查询操作的相关信息。
是否支持访问样例数据？	的样例数据默认保存在OBS中，所有云服务用户均拥有访问权限，当前不支持管理数据的权限。如果需要访问样例数据，可以通过OBSBrowser的挂载外部桶功能，加载样例数据所在的桶，然后查看目录访问样例数据。
应用程序是否需要支持自动重连数据库	建议您的应用程序支持自动重连数据库，当数据库重启后，无需人工介入，应用会自动恢复，提供更高的可用性。同时建议您的应用程序采用长连接方式连接数据库，以降低资源消耗，提高性能。
什么是备份策略？	备份策略指的是对备份对象执行备份操作时，预先设置的策略，策略包括备份策略的名称，备份任务的调度计划，备份数据的保留策略。其中调度计划包括备份执行的频率，备份执行的时间点，备份数据的保留策略包括备份数据的保存时间或保存数量。通过将云服务器绑定到备份策略，可以为云服务器执行自动备份。
MRS是否支持变更MRS集群节点？	管理控制台不支持变更集群节点，也不建议用户在ECS管理控制台直接修改MRS集群节点。如果手动在ECS管理控制台对集群节点执行停止ECS、删除ECS、修改或重装ECS操作系统，以及修改ECS规格的操作，可能影响集群稳定运行。如果您对MRS集群节点进行了上述操作，MRS会自动识别并直接删除发生变更的集群节点。您可以登录MRS管理控制台，通过扩容恢复已经删除的节点。请勿在扩容过程中对正在扩容的节点进行操作。
是否可以在不同的地域之间实施应用灾备？	可以。您可以将应用的主备节点部署到不同的地域，当主节点应用出现故障，备节点应用可以继续为您的客户提供服务。
如何选择操作系统？	适用于Windows环境下的开发平台或运营业务。系统盘要求40GB及以上、内存1GB及以上。可以安装IIS、SQLServer等。适用于Linux环境下的开发平台或运营业务。当前提供CentOS推荐和Ubuntu类型等操作系统。系统盘要求40GB及以上、内存512MB及以上。以上内存操作系统选择如果使用4GB及以上内存，请选择64位及以上的操作系统位操作系统只能4GB内寻址，超过4GB的内存操作系统无法访问
OBS是否支持网站重定向？	是否支持网站重定向？显示静态网站托管是否支持网站重定向？是否支持网站重定向？支持。在使用静态网站托管功能时，OBS支持配置请求重定向，即您可以将特定的请求或所有请求实施重定向。典型的应用场景包括：重定向所有请求到另外一个站点。设定特定的重定向规则，对特定的请求实施重定向。
AK/SK证书文件是否会过期？	会过期，认证文件默认有效时间为一年，超过期限需要重新上传认证文件，选择总览认证上传访问密钥已过期
消息通知服务支持的传输协议有哪些？	消息通知服务支持的协议有邮件短信：消息以HTTP请求的形式发送到订阅的URL，目前只支持公网域名。邮件：消息以电子邮件形式发送到订阅的邮箱地址。短信：消息以短信文本消息发送到订阅的电话号码。：使用已发布的消息的负载调用订阅的Functionstage终端。
软件开发云中免费额度是什么？	软件开发云中的免费使用额度指的是当前系统中的使用量，而不是累计使用量。比如：在项目中上传了一个10M的文件，误删后重新上传，使用量计为10M。
弹性云服务器按需计费和扣款周期是多少?	弹性云服务器按需是每小时计费，先使用后付费。
服务单状态是“待回寄磁盘”是什么意思？	待回寄磁盘是什么意思？当数据完成传输后，服务单状态将变为待回寄磁盘，此时数据中心管理员将安排回寄您的磁盘。
华为用的什么迁移工具？	迁移工具简称是华为自研的迁移工具，提供将主机服务器或其他特定虚拟化平台的虚拟机系统及数据完整迁移到FusionCompute环境虚拟机上的功能。
使用外部镜像文件创建私有镜像所创建的云服务器在启动过程中提示找不到分区，如何处理？	通常是由于跨平台后，磁盘分区的ID发生变化，导致镜像无法按照原来磁盘分区ID查询对应的分区名，此时需要将镜像中的磁盘分区修改为磁盘分区的UUID以OpenSUSE13的镜像为例，修改分区名的操作步骤如下。执行以下命令，确认当前磁盘分区对应的ID。回显类似如下所示。其中，表示该云服务器的磁盘为qemu模拟设备。磁盘分区ID为左侧内容，对应的分区名为右侧内容。执行以下命令，确认当前磁盘分区对应的UUID。回显类似如下所示。其中，每条磁盘信息中，左侧为磁盘的UUID，右侧为对应的磁盘分区名。结合结果，可以得到磁盘分区名，磁盘分区ID和磁盘分区UUID的对应关系。执行以下命令，查看文件中分区名称。回显类似如下所示。回显中第一列为磁盘分区ID。进入编辑模式，按照的查询结果，将文件中所在行磁盘分区ID修改为磁盘分区的UUID的形式。修改结果如下所示。
按需付费的产品我不能购买是什么原因？	按需付费的产品需要您帐号上至少有100元现金才能购买，请确保您帐号上的现金金额充足。
弹性伸缩有什么限制？	弹性伸缩的云服务器中运行的应用需要是无状态、可横向扩展的。因为AS会自动释放云服务器，所以弹性伸缩组内的ECS云服务器不可以保存应用的状态信息例如session和相关数据如数据库、日志等如果应用中需要ECS云服务器保存状态或日志信息，可以考虑把相关信息保存到独立的服务器中。弹性伸缩服务对用户的资源数量或容量做的配额限制如表1所示。表1配额一览表类别描述默认值弹性伸缩组用户可以创建的最多伸缩组个数弹性伸缩配置用户可以创建的最多伸缩配置个数弹性伸缩策略某个弹性伸缩组下可以创建的最多伸缩策略个数弹性伸缩实例某个弹性伸缩组下可以创建的最多实例个数
什么是安全指数服务？	安全指数服务是关于云环境的一个安全评估服务，为用户提供统一、直观、多维度的安全视图。用户可以通过安全指数服务了解所使用云环境是否已合理配置，所采取的安全措施是否已经足够，以及主动安全、被动安全的概况。用户在安全指数服务中可以快速地进入各安全相关项进行配置。
CDN是对网站所在的服务器加速，还是对域名加速？	是对域名进行加速，当启用CDN加速后，加速域名下的所有文件的访问请求都将转向CDN节点。
分布式缓存服务支持通用的Redis客户端（如Jedis）吗？	如Jedis吗？支持。任何兼容Redis协议的客户端都可以访问分布式缓存服务。Redis客户端的下载，请参见
如何获取裸金属服务器的管理员密码？	裸金属服务器配置完成后，我们会以邮件方式通知您该服务器的初始密码。首次登录服务器后，请及时修改密码。系统无法获取您的新密码，所以需要您妥善保管。
什么是负载均衡协议（端口）？	端口系统支持4层和7层两种协议的负载均衡，可通过具体提供的服务能力选择对应的协议以及该协议对外呈现的端口。
未安装VMTools对弹性伸缩组监控指标有什么影响?	未安装VMTools，云监控服务无法提供监控弹性云服务器的内存使用率、磁盘使用率、带内网络流入速率和带内网络流出速率四个指标。但可以监控带外网络流入速率和带外网络流出速率指标，这样导致CPU使用率指标的精确性可能会降低。如果弹性云服务器类型是IO优化实例，无论是否安装了vmtools，云监控服务监控弹性云服务器的监控指标不包含磁盘使用率、带内网络流入速率和带内网络流出速率指标。弹性伸缩组支持的监控指标，请参见表1因此，当上述情况发生时，弹性伸缩组支持的内存使用率、带内网络流入速率和带内网络流出速率三个指标会受到影响，无法获取监控数据。
不同地域之间的云服务器可以使用负载均衡吗？	暂不支持。建议您在不同地域使用不同的负载均衡
每条消息会让订阅者收到多少次？	每条消息只会让订阅者收到1次，如遇网络问题或设备故障可能会有重发的情况。
云专线如何退订？	请联系客服完成云专线的退订。
数据仓库服务的优势有哪些？	数据仓库服务可通过web管理控制台，让用户自助完成创建数据仓库与管理维护，系统可用性高：快速部署在DWS管理页面中可以方便的创建集群，即开即用。便捷管理有完善的性能监控体系和多重安全防护措施，是专业、高性能的分析型数据库管理平台。架构兼容性采用Share架构的MPP系统，支持SQL92、SQL2003标准，具备完备的事务处理能力，提供标准的JDBC、ODBC和gsql等多种客户端工具，并兼容Postgres生态。
如何保护弹性云服务器安全？	我们提供了虚拟化防病毒从云市场购买、Web漏洞扫描、主机加固与防护从云市场购买、Anti流量清洗、Web应用防火墙等安全产品服务；同时我们也提供了虚拟私有云服务，您可以利用安全组服务保证您网络的逻辑安全隔离。
怎样创建用于存放使用DES服务传输的数据的桶？	您需要开通对象存储服务，在OBS服务中创建桶用于存放使用DES服务传输的数据。登录OBSConsole。在主页面单击创建桶点击放大系统弹出下方所示的对话框。说明：由于通过URL访问桶时，桶名会作为URL的一部分，根据DNS标准，URL不支持大写字母，无法区分带大写字母的桶。因此，桶名称仅支持小写字母、数字、作为桶的命名规则。例如：若想通过URL访问名为的桶，该URL将解析成名为的桶，导致访问出错。
每个队列可以创建多少消费组？	每个队列最多可以创建三个消费组，且消费组数量无法扩充配额。
外部服务器能否访问RDS数据库	外部服务器不能直接访问RDS数据库，访问方式如下：在VPC中开通VPN，通过VPN连接RDS数据库。将RDS与ECS创建在同一个VPC下，通过ECS来访问RDS数据库。
同一个产品可以被添加到多个产品组合吗？	可以。您可以根据需求将产品1和其他产品添加到产品组合A中分配给一些用户，还可以将产品1和另外一些产品添加到产品组合B中分配给另一些用户，来满足产品的组合包装和灵活分配。
什么是弹性文件服务？	弹性文件服务提供按需扩展的高性能文件存储，可供云上多个弹性云服务器共享访问。SFS提供标准的文件访问协议，用户可以将现有应用和工具与SFS无缝集成。文件系统提供简单易用的操作界面，用户可以简单快捷地创建和配置文件系统，快速完成文件系统的部署、扩展和优化等运维事务。此外，文件系统还具备高可靠和高可用的特点。SFS文件系统的性能随容量增加而提升，可广泛应用于业务应用场景，例如媒体处理、高性能计算、内容管理和主目录。
会议用户通过邮件找回密码失败？	通过邮件找回密码失败？重置密码链接的有效时长为5分钟，超出时长则链接失效，此时需重新进行找回密码的操作。具体操作方法，请参考如何找回会议用户密码？
是否支持实例扩容？	实例当前所触发的计算任务都在对应的MRS集群中完成，MLS实例本身暂不提供扩容能力，但能够基于MRS集群完成计算能力的扩容。
如何使用代码检查？	代码检查在云端代码检查中可以进行静态检查、安全检查、编码规范检查等，并对检查出的问题提供修改方法。
DDM是否支持分布式JOIN	支持分布式JOIN。表设计时，增加字段冗余支持跨分片的JOIN，主要实现的方式有三种：全局表，ER分片和ShareJoin。
云目录服务是否收取费用？	云目录服务本身不收取费用。但会按创建的产品实例按照所使用的资源收取资源的费用。如产品实例为云服务器实例时，收取云服务器的费用。
客户端登录提示失败？	原因一服务器地址配置错误。请在设置中确认服务器地址配置为下拉菜单中的选项华为云会议原因二客户端登录环境存在网络限制。请确认当前网络是否能直接访问网址：mdx。如无法访问，请更换客户端网络环境。原因三注册失败。请联系客服人员，检查SIP号码是否被加入黑名单。
无法成功创建机器学习服务实例时怎么处理？	检查原因检查用户是否已经没有配额创建新的机器学习服务实例。检查用户是否已经申请了最新版本的MRS集群。
是否会保证将消息传送到订阅的终端节点？	如果订阅终端节点可以送达，消息通知服务会确保消息传送到订阅终端节点。如果订阅终端节点无法送达，消息通知服务会将发送失败的消息保存到失败的消息队列尾部，等待下次被发送。如果发送失败次数超过6次，消息将直接丢弃，不再保存到失败的消息队列，且不会给用户发送消息发送失败的相关信息。失败的消息队列中的消息处理间隔时间是不确定的，它取决于失败的消息队列的长度。一般会在数小时之内处理完成，如果失败消息队列中的内容太多，则会在一天之内处理完成。
数据仓库可以存储多少业务数据？	数据仓库集群每个节点默认能够支持3或512GB的存储容量。数据仓库系统会生成索引、临时缓存文件、运行日志等内容，并占用存储容量。每个节点实际存储的数据，可能小于总存储容量。
云专线冻结后，是否可以正常使用？	云专线订单到期后，宽限期内一般7天内仍然可以继续使用资源。用户可以在此时续订云专线。宽限期结束后，会进入冻结状态，冻结状态时资源无法正常使用。用户在冻结期内续订云专线，可以解除冻结，继续使用资源。冻结状态会持续一定时间，如果超过该时限，资源会被删除，用户无法续订。冻结状态的持续时间，由华为云控制，请联系客服了解详情。
华为云迁移有什么特点？	支持在线迁移。支持X86架构下主流的Linux、Windows等操作系统平台迁移，部署简。支持基于Windows和Linux在线块级迁移、文件级迁移、数据同步，以及基于Windows的在线分段块级迁。支持基于华为FusionSphere云平台的P2V和V2V业务迁移操作。支持并发迁移任务。支持断点续传。多次数据同步功能保障数据一致性。
为什么VNC方式登录弹性云服务器时，界面提示认证成功，但是系统黑屏输入无反应？	这是因为该弹性云服务器已被其他用户使用VNC方式登录。方式登录弹性云服务器时，同一时刻仅支持一个用户登录。如果多个用户同时登录，除第一个用户可正常登录外，其他用户登录时只会提示认证成功，但是不显示画面，出现黑屏现象。此时，用户需等待其他用户退出VNC登录后，才能继续登录。
我购买的弹性云服务器是否在同一子网？	由于您可以自定义网络，所以弹性云服务器是否在一个子网，完全由您来控制。
数据传输完成后我能不能知道详细的传输结果？	用户数据上传完成后，会生成数据传输报告，以报表形式供用户确认数据传输完整性。数据传输报告中包含如下表所示内容：参数说明传输数据统计类型，分别是按照传输的对象个数和传输的数据字节计算。总传输数据，包含总传输的对象个数和传输数据的总字节数。总传输成功数据，包含总传输成功的对象个数和传输成功数据的总字节数。总传输失败数据，包含总传输失败的对象个数和传输失败数据的总字节数。
什么是RDS数据库连接数	数据库连接数表示应用程序可以同时连接数据库的数量，与您的应用程序或者网站能够支持的最大用户数没有关系。
开始标注不成功	不能调用开启共享就调用启动标注，需要等待第一帧发送完成后才能启动标注。
监听器是什么？	承担ELB具体的协议和端口配置；云服务器协议和端口配置；监听策略配置。
伸缩组异常情况下如何处理？	伸缩组异常情况及其处理方法：情况描述：云服务器配额不足、云硬盘配额不足、弹性IP配额不足等。可能原因：配额不足。处理方法：申请扩大配额或者删除不需要的资源，之后重新启用伸缩组。情况描述：VPC不存在、安全组不存在、子网不存在。可能原因：虚拟私有云服务异常或者相关资源被删除。处理方法：等待虚拟私有云服务恢复或者修改伸缩组中VPC、子网、安全组相关参数，之后重新启用伸缩组。情况描述：负载均衡监听器不存在。可能原因：负载均衡服务异常或者相关资源被删除。处理方法：等待负载均衡服务恢复或者修改伸缩组中负载均衡相关参数，之后重新启用伸缩组。情况描述：镜像不存在、伸缩配置使用的密钥对不存在等。可能原因：相关资源被删除。处理方法：为伸缩组更换新的伸缩配置，之后重新启用伸缩组。情况描述：生命周期挂钩使用的通知主题不存在。可能原因：伸缩活动开始前生命周期挂钩使用的通知主题被删除，如果伸缩活动开始后通知主题被删除，则下次伸缩活动时伸缩组会异常。处理方法：修改生命周期挂钩使用的通知主题，之后重新启用伸缩组。情况描述：您选择的子网下私有IP不足。可能原因：该子网下私有IP地址被用尽。处理方法：修改伸缩组的子网信息，之后重新启用伸缩组。情况描述：您选择的可用分区下的该类型云服务器资源已售罄，请选择其他可用分区。可能原因：您为伸缩组选择的可用分区下资源售罄，或者该可用分区不支持该类型云服务器，该类型云服务器指的是伸缩配置里选择的云服务器类型。处理方法：修改伸缩组的子网信息，之后重新启用伸缩组。
云服务器是否可以更换地域？	暂不支持。
源站域名可以和加速域名一致吗？	不可以。用户访问加速域名的网站资源，当CDN节点上没有缓存对应的内容时，CDN节点会回到源站获取，然后再返回给用户。如果源站域名与加速域名一致，将会造成访问请求反复解析到CDN节点，导致CDN节点无法回源拉取请求内容。
什么是节点？	每一个节点对应一台虚拟机，容器应用运行在节点上。节点上运行着代理程序，用于管理节点上运行的容器实例。节点规格最小是CPU为1core，内存为2048MB；最大是CPU为32core，内存为128GB。
使用分布式缓存服务，需要在弹性云服务器上安装Redis吗？	不需要。您只需要通过相应的Redis客户端即可从弹性云服务器上连接使用缓存实例。
不同帐号下裸金属服务器内网是否可以互通？	不同帐号下的裸金属服务器内网是不通的。
通过镜像文件注册私有镜像过程中，系统会对镜像做哪些修改？	如果您通过镜像文件注册私有镜像选择了进行后台自动化配置的方式，那么后台系统会进行以下操作。对于Linux操作系统：修改配置文件，增加内核启动参数，并将磁盘分区名改成磁盘分区的UUID检查文件中的磁盘分区名并修改成磁盘分区的UUID的形式。检查文件是否含有XEN和IDE驱动，若不含有，则加载XEN和IDE驱动。修改配置文件，避免图形化界面显示失败。删除VMwaretools对应的服务。针对这4款Linux：CentOS7、centos6、SUSESLES11SP4、redhat7，会添加Linux操作系统自带的virtio前端驱动到initrd或initramfs中。
安全指数服务是否收费？	此项服务是免费提供的。
综合迁移交付服务报价及支付方式？	报价及影响因素说明：标准业务迁移服务方案按照整体打包的方式向用户销售，因而它的服务价格以项目整体报价，不存在分项报价和报价组合的说法。定制化业务迁移服务方案报价根据你方需求评估工作时间，再以人天方式进行项目整体报价。最终的服务报价与虚拟机数量、待迁移数据量以及服务时间等因素相关。支付方式说明：支付方式为用户经理代理下单，用户在控制台收到支付订单支付即可。
Windows2012系统卸载某些软件后无法进入系统桌面怎么办？	问题描述针对Windows2012操作系统，由于安装应用系统会用到，而2012自带的版本需要卸载，但是卸载之后可能会遇到黑屏、无法进入系统桌面的问题，只能调出任务管理器。
快照有多少种状态	快照有如下几种状态，每种状态的意义及支持的操作如表1所示。表1快照状态描述快照状态状态描述支持的操作正在创建快照处于正在创建的过程中。不能进行任何操作可用快照创建成功。通过快照创建云硬盘删除快照回滚快照数据至云硬盘正在删除快照处于正在删除的过程中。不能进行任何操作错误快照在创建过程中出现错误。删除删除失败快照在删除过程中出现错误。不能进行任何操作正在回滚快照处于正在快照回滚数据的过程中。说明：只支持快照回滚到源云硬盘，不支持快照回滚到其它指定云硬盘。只有当云硬盘的状态处于可用回滚数据失败状态才允许快照回滚到源云硬盘。
如何正确使用软件开发云登录首页？	软件开发云软件开发云首页展现内容包括功能菜单区首页、项目、工作项、服务、登录账号、用户区域、管理控制台、消息中心、帮助中心、关注我们和下载APP、我的头像、我的项目、我的工作项、企业成员管理、我的历程和最新消息等，如图1所示。图1软件开发云首页
消息通知服务有哪些优势？	消息通知服务的突出优势有以下三点：消息通知体系需要大量投入资源进行开发以及维护，使用SMN服务可以大幅降低成本。无需考虑消息通知体系的可靠性以及扩容问题。消息通知服务接入简单、学习成本低。
软件开发云中各个区域有什么区别？	各个区域只代表软件开发云数据存储节点不同，功能完全相同，选择任意区域注册的账号，各个区域均可使用。进入软件开发云首页，在页面右上角可以切换区域，如图1所示。图1软件开发云首页
什么是弹性云服务器的按需计费？	按需每小时计费，不足一小时以实际使用时长为准。
服务单状态是“正在传输”是什么意思？	正在传输是什么意思？当您填写AK和加密密钥后，系统将启动数据上传，此时服务单状态将为正在传输，并保持至数据传输完成。
什么是跨域资源共享？	什么是跨域资源共享？显示跨域资源共享什么是跨域资源共享？什么是跨域资源共享？跨域资源共享，Cross是由W3C标准化组织提出的一种网络浏览器的规范机制，定义了一个域中加载的客户端Web应用程序与另一个域中的资源交互的方式。而在通常的网页请求中，由于同源安全策略SOP的存在，不同域之间的网站脚本和内容是无法进行交互的。对象存储服务支持以下三种存储类别：标准存储、低频访问存储、归档存储。存储类别为标准和低频访问的桶支持配置CORS规则。
图形化编排校验报错的解决方法？	表1图形化编排校验报错的解决方法错误提示解决方法拖拽一个新的容器到组件中。将容器拖拽到组件中。拖拽一个新的端口或新的端口和数据卷到容器中。将端口拖拽到容器中。拖拽一个新的端口到容器中。容器中配置的image值不正确，如为空，有除字母、的非法字符，长度超过255等。将在组件中的组件拖拽到组件外。删除容器中多余的端口，仅保留一个端口。
公有云是否提供应用灾备的相关服务？	暂时没有标准的灾备方案，如果您需要，请联系我们，我们将结合您的应用场景给您做定制方案。
事件列表中的信息可以删除吗？	不可以。OBS中的事件为永久存储。
应用程序怎么访问VPC中的DDS实例	您需要确保您的应用程序所在的ECS，与实例在同一个VPC中。如果不在，需要修改VPC中的路由表和网络ACL，以确保应用程序所在的ECS能够访问
如何使用精简流程项目管理？	项目管理的开发流程分为精简流程项目流程项目，以下介绍精简流程项目的操作流程。精简流程项目管理提供了需求、任务、缺陷三种类型的工作项管理，用户在项目中根据实际需要新建不同类型的工作项，指定责任人、优先级、计划日期、预计工时以及跟踪工作项状态和进度管理等。
应用程序怎么访问VPC中的RDS实例	您需要确保您的应用程序所在的ECS，与RDS实例在同一个VPC和子网中。如果不在，需要修改VPC中的路由表和网络ACL，以确保应用程序所在的ECS能够访问RDS实例。
是否支持使用JDBC或ODBC连接？	支持使用JDBC或ODBC应用程序连接数据库。应用程序可以在公有云环境的弹性云服务器中，或者互联网环境连接数据库。在Windows环境使用JDBC连接已安装JDK1或以上版本，并配置环境变量。登录DWS管理控制台，单击连接管理下载驱动程序区域，单击下载链接这里下载证书文件。配置证书以使用SSL加密连接。解压压缩包得到证书文件。证书文件建议保存在英文路径，配置证书时需要根据实际情况指定路径，否则可能提示文件不存在。打开命令提示符程序，执行以下两条命令，转化根证书并导入到trustStore中。为解压后获取的根证书。为生成的中间文件。根据实际情况，可以填写保存到其他路径，也可以自定义文件名称。为生成的可信库名称，为别名用户，二者可以根据需要进行修改。请用户根据提示信息输入自定义的可信库密码并确认密码例如，然后输入确认信任证书。执行以下命令转化客户端私钥。需要输入客户端私钥的密码，然后输入并确认用户自定义的私钥密码例如执行以下命令，将私钥导入到keyStore中。下载JDBC驱动，并解压得到在应用程序的工程中，设置引用Jar包。加载驱动。支持以下两种方法加载：在代码中隐含装载：Class在JVM启动时参数传递：java使用JDBC的数据库链接方法DriverManager此方法支持以下重载：表1数据库连接参数参数描述数据库连接描述符，可以在管理控制台查看。格式如下：说明：为要连接的数据库名称。为数据库服务器名称。为数据库服务器端口。缺省情况下，会尝试连接到localhost的8000端口的database。
分布式缓存服务默认的数据逐出策略是什么？	逐出指将数据从缓存中删除，以腾出更多的存储空间容纳新的缓存数据。默认策略为不逐出。当前版本支持在配置运行参数中修改逐出策略。在达到内存上限时Redis支持选择以下6种数据逐出策略：：在这种策略下，如果缓存达到了配置的上限，实例将不再处理客户端任何增加缓存数据的请求，比如写命令，实例直接返回错误给客户端。缓存达到上限后，实例只处理删除和少数几个例外请求。：根据LRU，最近最少使用算法尝试回收最少使用的键，使得新添加的数据有空间存放。：根据LRU，最近最少使用算法尝试回收最少使用的键，但仅限于在过期集合的键，使得新添加的数据有空间存放。：回收随机的键使得新添加的数据有空间存放。：回收随机的键使得新添加的数据有空间存放，但仅限于在过期集合的键。：回收在过期集合的键，并且优先回收存活时间较短的键，使得新添加的数据有空间存放。说明：当没有键满足回收前提条件时，数据逐出策略volatile、volatile、volatile与noeviction策略相同，具体见上文noeviction介绍。
为什么端口变更后实例状态异常	现象描述端口变更后该实例状态为故障使用变更后端口号无法连接实例。
云报表服务支持哪些类型视图？	柱状图、折线图、面积图、饼状图、散点图和箱线图。
为什么数据管道的订单到期时间显示不一致？	为即将到期的数据管道续费后，在页面中显示该数据管道的到期时间为续费后的时间，可是在数据调度服务的页面中查看该数据管道的到期时间为续费前的。原因是：用户完成续费后，用户中心将会为此数据管道分配新的订单号此处称为续订订单号，并在续费管理中显示续费后的有效期限。当数据管道当前的订单号过期时，用户中心将向数据调度服务系统传递此数据管道的续订订单号信息，此时数据调度服务系统将在详细信息页面中刷新该数据管道的有效期限为续费后的。由于在数据调度服务系统中，此数据管道当前的订单号还未到期，所以页面显示的是当前订单号的有效期限，即续费前的有效期限。
我在什么场景下需要使用生命周期管理？	我在什么场景下需要使用生命周期管理？显示生命周期管理我在什么场景下需要使用生命周期管理？我在什么场景下需要使用生命周期管理？生命周期管理可适用于以下典型场景：周期性上传的日志文件，可能只需要保留一个星期或一个月。到期后要删除它们。某些文档在一段时间内经常访问，但是超过一定时间后就可能不会再访问了。这些文档需要在一定时间后删除。对于上述场景中的对象，您可以定义用于识别这些对象的生命周期管理规则，通过这些规则实现对象的生命周期管理。自动删除无用的文件后，由于您使用的OBS存储空间减少，这将一定程度上减少您的租赁费用。
什么是本地进程的哈希值？	哈希值是用来区分同一个进程的各历史状态的唯一标识。
分布式消息服务是否能保证消息不重复？	不能保证消息不重，但是在绝大部分情况下，消息是不重复的，在网络异常情况下，会出现消息重复。
客户端连接缓存实例超时后怎么办？	建议重新连接缓存实例。超时可能是网络原因，也有可能是服务器端其他因素引起，比如当客户端应用对缓存实例超载或者缓存实例发生了主备切换，会导致Redis客户端出现或者提示。由于部分客户端不支持与缓存实例的自动重连，因此建议用户在应用程序中增加重新建立连接的功能。
什么是渗透测试？	渗透测试，是指专业的安全测试人员利用各种技术、管理手段和实地验证对某个特定的网络系统进行探测，以便发现系统中存在的漏洞、缺陷，然后输出测试报告并提交给网络所有者。网络所有者根据安全公司提供的渗透测试报告，可以清晰了解系统中存在的安全隐患和问题，以便采取必要的防护措施。
使用UDP协议有什么注意事项？	负载均衡健康检查是通过UDP报文和Ping报文探测来获取后端主机的状态信息。针对此种情况，用户需要确保后端主机未关闭ICMP协议，确认方法如下：用户登录后端云主机，以root权限执行以下命令：若返回值为1，表示ICMP协议关闭；若为0，则表示未关闭。当前UDP协议服务健康检查可能存在服务真实状态与健康检查不一致的问题：如果后端ECS服务器是Linux服务器，在大并发场景下，由于Linux的防ICMP攻击保护机制，会限制服务器发送ICMP的速度。此时，即便服务已经出现异常，但由于无法向前端返回报错信息，会导致负载均衡由于没收到ICMP应答进而判定健康检查成功，最终导致服务真实状态与健康检查不一致。当负载均衡的类型为私网时，不允许创建UDP协议的监听器。
DataPipelineService可以做什么?	使用DataPipelineService，用户可以通过简单的拖拽操作来定制数据管道；用户可以设置定时参数执行数据管道；用户可以定义任务成功或失败后需要执行脚本策略。提供多种数据采集和处理，可以将用户从复杂的数据流编制过程中解放出来，让用户专注于数据处理逻辑而不是编程工作。
每个用户可以创建多少个消息模板？	每个用户可以创建100个消息模板。
如果删除云帐号快照是否会被删除	一旦删除云帐号，自动快照和手动快照的数据也随之删除。
忘记密码如何处理	用户忘记密码时，可以联系管理重置密码，重置后的密码将发送到用户的邮箱。点击放大
机器学习服务支持哪些格式的数据源？	机器学习服务支持以下格式的数据源：表。种HDFS文件格式：
DDS支持的最大IOPS是多少	详见数据库实例规格
会议设备初次使用如何配置？	初次使用如何配置？如您使用的会议设备型号为TE10，只需要在首次使用时，初次使用需输入激活码。说明：配置前需确认该会议设备已在会议管理控制台上添加完成。激活码有效期为15天，时间自会议设备会议管理控制台上添加完成之日起计算。如激活码已失效，请登录会议管理控制台，重置该会议设备的激活码。安全起见，如您在五分钟内，激活码连续输入错误次数累计10次以上，系统将锁定该会议设备所在IP地址，请10分钟后再试。
什么是用户主密钥？	用户主密钥，即CMK，是用户使用密钥管理服务创建的密钥，是一种密钥加密密钥，主要用于加密并保护数据加密密钥。一个用户主密钥可以加密多个数据加密密钥。
生命周期管理	显示生命周期管理生命周期管理
我可以上传同名对象到指定的一个文件夹中吗？	我可以上传同名对象到指定的一个文件夹中吗？显示多版本控制我可以上传同名对象到指定的一个文件夹中吗？我可以上传同名对象到指定的一个文件夹中吗？若开启了多版本控制，上传对象时，OBS自动为每个对象创建唯一的版本号。上传同名的对象将以不同的版本号同时保存在OBS中。若未开启多版本控制，向同一个文件夹中上传同名的对象时，新上传的对象将覆盖原有的对象。
云硬盘有几种类型	云硬盘类型有三种：超高IO、高IO和普通IO。
云监控是什么？	云监控服务是一个开放性的监控平台，即可提供资源的监控、告警、通知等服务。目前可以监控弹性云服务器云硬盘虚拟私有云关系型数据库分布式缓存服务分布式消息服务弹性负载均衡弹性伸缩服务应用防火墙主机漏洞检测云桌面机器学习服务网页防篡改数据仓库服务人工智能服务的相关指标。用户可以通过这些指标设置告警规则和通知策略，以便及时了解各产品服务的实例资源运行状况和性能。云监控服务主要由如表1所示三部分组成。表1云监控主要组成名称主要功能总览显示云监控服务对接的各服务的监控指标数，并可添加、删除监控项。各服务可关注的指标如下所示。弹性云服务器12个指标：CPU使用率、磁盘读速率、磁盘读操作速率、磁盘使用率、磁盘写速率、磁盘写操作速率、内存使用率、带内网络流入速率、带内网络流出速率、带外网络流入速率、带外网络流出速率、系统状态检查失败。云硬盘4个指标：磁盘读速率、磁盘写速率、磁盘读操作速率和磁盘写操作速率。弹性伸缩服务5个指标：CPU使用率、内存使用率、实例数、网络流入速率和网络流出速率。弹性负载均衡10个指标：并发连接数、活跃连接数、非活跃连接数、新建连接数、流入数据包数、流出数据包数、网络流入速率、网络流出速率、异常主机数和正常主机数。虚拟私有云4个指标：上行带宽、下行带宽、上行流量、下行流量。分布式消息服务8个指标：消息堆积数、已消费消息数、跳跃消费消息数、队列消息数、消息大小、消息请求数、死信消息堆积数、死信历史消息数。分布式缓存服务32个指标：CPU利用率、内存利用率、网络输入吞吐量、网络输出吞吐量、活跃的客户端数量、客户端最长输出列表、客户端最大输入缓冲、阻塞的客户端数量、已用内存、已用内存RSS、已用内存峰值、Lua已用内存、内存碎片率、总共收到的连接数、总共处理的命令数、每秒并发操作数、网络总共收到字节数、网络总共发送字节数、网络瞬时输入流量、网络瞬时输出流量、已拒绝的连接数、全量同步次数、增量同步成功次数、增量同步出错次数、已过期的键数量、已挤出的键数量、Keyspace命中次数、Keyspace错过次数、Pubsub通道个数、Pubsub模式个数、AOF文件当前大小和最近Fork耗时。关系型数据库54指标：磁盘使用率、CPU利用率、内存利用率、IOPS、网络输入吞吐量、网络输出吞吐量、数据库总连接数、当前活跃连接数、QPS、TPS、缓冲池利用率、缓冲池命中率、缓冲池脏块率、InnoDB读取吞吐量、InnoDB写入吞吐量、InnoDB文件读取频率、InnoDB文件写入频率、InnoDB日志写请求频率、InnoDB日志物理写频率、InnoDB日志fsync写频率、临时表数量、KeyBuffer利用率、KeyBuffer写命中率、KeyBuffer读命中率、MyISAM硬盘写入频率、MyISAM硬盘读取频率、MyISAM缓冲池写入频率、MyISAM缓冲池读取频率、Delete语句执行频率、Insert语句执行频率、Insert语句执行频率、Replace语句执行频率、Replace语句执行频率、Select语句执行频率、Update语句执行频率、行删除速率、行插入速率、行读取速率、行更新速率、事务日志使用量、复制插槽使用量、数据库连接数、事务最大已使用ID数、事务日志生成速率、最滞后副本的滞后量、复制时延、磁盘总大小、磁盘使用量、磁盘读吞吐量、磁盘写吞吐量、磁盘读耗时、磁盘写耗时、磁盘平均队列长度、使用中的数据库连接数。应用防火墙6个指标：SQL注入告警个数、XSS跨站脚本漏洞告警个数、Webshell上传告警个数、盗链告警个数、IP黑名单告警个数、IP白名单告警个数。主机漏洞检测服务3个指标：高危漏洞个数、中危漏洞个数、低危漏洞个数。云桌面服务6个监控指标：CPU使用率、内存使用率、磁盘使用率、IOPS、网络输入吞吐量、网络输出吞吐量。机器学习服务3个指标：CPU使用率、内存使用率、磁盘使用率。网页防篡改1个指标：网页防篡改告警个数。数据仓库服务22个指标：缓存命中率、内存中排序比率、文件读取次数、文件写入次数、每秒文件读取次数、每秒文件写入次数、数据量大小、活跃SQL数、会话数、CPU使用率、内存使用率、IOPS、网络输入吞吐量、网络输出吞吐量、磁盘利用率、磁盘总大小、磁盘使用量、硬盘读吞吐量、硬盘写吞吐量、硬盘读耗时、硬盘写耗时、磁盘平均队列长度。人工智能服务2个指标：调用单据识别成功次数、调用单据识别失败次数。实例监控当用户开通了弹性云服务器、云硬盘、虚拟私有云、弹性负载均衡、弹性伸缩服务、分布式缓存服务、人工智能服务、Web应用防火墙、主机漏洞检测、机器学习服务、网页防篡改、数据仓库服务、关系型数据库、云桌面或分布式消息服务，无需额外安装其他插件，即可查看对应服务的实例状态。告警用户可添加、查看、修改、删除、启停告警规则。
弹性负载均衡支持哪些转发方式？	当前ELB支持轮询、最小连接数和源地址三种模式的转发规则。轮询：将请求轮流发送给后端云服务器，常用于短连接服务，例如HTTP等服务。最少连接：优先将请求发给拥有最少连接数的后端云服务器，常用于长连接服务，例如数据库连接等服务。源地址：将请求的源地址进行hash运算，派发请求至某匹配的服务器，这可以使得同一个客户端IP的请求始终被派发至某特定的服务器。该方式适合负载均衡无cookie功能的TCP协议。
如何将RDS数据库备份到弹性云服务器上	您可以通过导出SQL语句的方式将数据库备份到弹性云服务器ECS上。ECS不限制存放哪些数据，只要符合国家法律法规就行。您可以在ECS上存放数据库备份，但不建议将ECS作为数据库备份空间使用。强烈推荐使用RDS的备份功能将备份数据存放到专业的对象存储OBS上，以获得更高的数据可靠性和服务保障。
什么是mcore？	是CPU使用单位，为千分之一个核。通常容器应用的CPU用量以mcore为单位衡量。
成员没有收到服务开通邮件怎么办	为成员开通帐号时，管理员会填写成员的邮箱信息，请确保填写正确，否则成员可能无法收到邮件。成员可以联系管理员重置密码，系统将再次发送邮件给成员。
共享pdf文档失败	共享pdf文档失败，原因是pdf文档没有关联到相应的打印程序。、确定pdf阅读器有没有安装，数据会议支持adobe和福昕阅读器。、右键pdf文档，查看菜单中是否有打印菜单，没有打印菜单，说明pdf没有关联打印程序，导致共享pdf时直接返回失败，这种情况需重新安装阅读器，并确保软件正确安装并注册成功。
OBS目前与哪些云服务商的对象存储服务兼容？	目前与哪些云服务商的对象存储服务兼容？显示一般性问题目前与哪些云服务商的对象存储服务兼容？目前与哪些云服务商的对象存储服务兼容？兼容AmazonS3RESTAPI。如果您有基于AmazonS3的业务，可以无缝地移植到OBS上。
如何准备机器学习服务的数据源？	与MRS集群无缝配合，可以从MRS集群中的HDFS或Hive组件中直接读取数据。MRS集群的数据源来源于OBS对象存储服务，并支持将OBS中的数据导入至HDFS中。用户需要将本地数据上传至OBS系统，通过MRS集群将OBS中的数据导入至HDFS中，在使用MLS时，直接从HDFS中读取数据。
裸金属服务器是否支持挂载云硬盘？	暂不支持。当前仅能使用裸金属服务器本地磁盘。
使用FunctionSage开发程序之后是否需要部署？	用户在本地开发程序之后打包，必须是ZIP包、Node、Python或者JAR包，上传至FunctionSage即可运行，无需其它的部署操作。
删除弹性负载均衡有什么影响？	如果您的ELB服务地址已经正常解析到域名且对外提供服务，除非必要请不要删除您创建的ELB服务，删除了ELB服务以后相应的服务配置和服务地址将会被释放掉，数据一旦删除，不可恢复。如果您重新创建ELB服务，系统会重新给您分配一个新的服务地址
告警规则在何种情况下会触发“数据不足”？	数据不足当某一个告警规则监控的告警指标连续三个小时内未上报监控数据，此时告警规则的状态将变为数据不足。如果用户在创建该告警规则时，勾选了数据不足发送通知，则系统会及时通过邮件或短信方式通知用户，以便用户及时查询问题；还可以通过HTTPPOST形式发送消息至服务器地址，供用户使用。特殊情况下，如果指标的上报周期大于三个小时，连续三个周期均未上报监控数据，则告警规则状态变为数据不足
访问RDS实例应该如何配置安全组	以ECS：192访问RDS实例数据库连接地址：192为例：通过ECS访问RDS实例时，ECS安全组需要配置出规则，如图1所示。图1安全组配置点击放大
通信平台云如何收费？	当前该服务处于公测阶段，暂不收费。
分布式消息服务是否提供对消息的先入先出(FIFO)访问？	访问？支持。DMS创建队列时，可以选择普通队列有序队列。有序队列适用于对顺序要求较高的场景，严格按照接收消息的顺序消费消息；普通队列适用于需要高并发度的场景，由于采用分布式设计，不能保证完全按照接收消息的顺序消费消息。
什么是图形化编排？	图形化编排工具可以通过拖拽的方式完成复杂应用的编排及拓扑设计，并且可以保存为应用模板，使用模板可以直接创建多个容器组成的复杂应用，简化应用部署难度，提升效率。
缓存刷新、缓存预热是怎样的使用场景？	缓存刷新源站内容更新后，希望用户可以获取到最新资源，CDN租户可以通过提交刷新请求将CDN节点上指定的缓存内容强制过期。当用户再次访问时，CDN节点将回源获取已更新内容返回给用户并在节点缓存最新资源。缓存预热提交指定资源的缓存预热请求后，对应源站资源将分发到CDN节点，当用户发起访问请求时，可以直接从CDN节点获取，有效地降低了回源率。
“删除”按钮是什么意思？	按钮是什么意思？删除是指删除已申请的裸金属服务器，删除时可以选择同时删除弹性IP。如果不选择，则会保留，您需要单独删除弹性IP。
我可以在OBS中存储多大的对象？	我可以在OBS中存储多大的对象？显示一般性问题我可以在OBS中存储多大的对象？我可以在OBS中存储多大的对象？每个对象的大小最小可达1字节，最大可至5TB。如果您调用PUTObject的API上传，上传单个对象最大为5GB；如果您调用多段上传的API上传，上传单个对象最大为5TB；如果您通过OBS管理控制台上传，上传单个对象最大为50MB；如果您通过OBS客户端上传，上传单个对象最大是5TB。
作业如何并发？	的SQL作业，不支持单个算子的并发，作业并发是指为流作业同时启动多个并发任务。
为什么实际调用次数与界面记录次数不一致？	控制台只记录服务调用成功的次数，调用失败的次数不计算在使用量内。可按以下方法查看调用失败的次数：登录管理控制台。在控制台首页选择人工智能服务，进入人工智能服务界面。在左侧导航栏中选择对应的服务如：单据识别，单击进入该服务界面，单击查看监控数据，进入CES控制台查看服务调用成功和失败的次数等具体信息。
指定接收组中可以勾选的主题数量有没有限制？	在编辑接收组可勾选的主题数量限制为10个不含默认接收组
什么是专属云？	专属云，以下简称DeC是在公有云上隔离出来的专属虚拟化资源池。在专属云内，用户可申请独占物理设备，独享计算和网络资源，并使用可靠的分布式存储。专属云在用户申请后才予以开通。用户可在管理控制台统一管理资源，就像自建私有云一样的灵活使用公有云。
云专线支持的最大带宽是多少？	常规物理云专线支持的最大带宽不超过10Gbit
API调用失败如何处理？	当SP调用API接口失败时，请按以下两种方式处理：对于错误码已经详细描述问题所在，根据错误码描述处理问题。对于系统错误，SP直接联系华为管理员处理。
统一身份认证服务中用户额度如何申请扩容？	统一身份认证服务中用户额度如最多只能创建50个用户使用完后，可以拨打华为云客服电话4000，描述情况并申请扩容。
可以通过创建模板的方式创建实例吗	目前不支持实例模板。
多版本控制	显示多版本控制多版本控制
操作系统及浏览器要求	会议管理控制台对浏览器的要求会议管理控制台支持的浏览器类型及版本，如表1所示。表1会议管理控制台对浏览器的要求类型要求会议管理控制台及以上版本及以上版本及以上版本及以上版本
云服务器能否跨区域备份？	当前只支持区域内备份和恢复，不支持跨区域备份和恢复。
测试管理服务各角色类型对应的操作权限是什么？	测试管理中用户的角色类型及对应的操作权限说明，如表1所示。表1操作权限说明角色操作测试设计测试执行用例管理验收报告设置项目创建者分配需求、设计用例分配用例、执行用例设置基线用例、关联需求、导入用例、导出用例、编辑用例、删除用例、查看用例查看验收报告、提交验收报告质量评价、导出验收报告、发送验收报告邮件设置目录配置、设置消息通知项目经理分配需求、设计用例分配用例、执行用例设置基线用例、关联需求、导入用例、导出用例、编辑用例、删除用例、查看用例查看验收报告、提交验收报告质量评价、导出验收报告、发送验收报告邮件设置目录配置、设置消息通知测试经理分配需求、设计用例分配用例、执行用例设置基线用例、关联需求、导入用例、导出用例、编辑用例、删除用例、查看用例查看验收报告、提交验收报告质量评价、导出验收报告、发送验收报告邮件设置目录配置、设置消息通知开发人员设计用例执行用例责任人导入用例、导出用例、编辑用例用例创建人、删除用例用例创建人、查看用例查看验收报告、导出验收报告、发送验收报告邮件测试人员设计用例执行用例责任人导入用例、导出用例、编辑用例用例创建人、删除用例用例创建人、查看用例查看验收报告、导出验收报告、发送验收报告邮件浏览者导出用例、查看用例查看验收报告、导出验收报告
出现错误或失败的云硬盘该如何处理	目前云硬盘有四种异常状态，当处于这些状态时，请参考下面处理建议。表1磁盘异常状态处理建议异常状态建议错误您可以删除错误状态的云硬盘后再重新创建。如果是创建包年包月的云硬盘时出现错误，客服会主动帮您解决此问题。如果您对客服响应速度有要求，请主动联系。删除失败请联系客服解决。删除失败的云硬盘不会继续计费。扩容失败客服会主动帮您解决此问题，在此之前建议不要对该云硬盘做其他操作。如果您对客服响应速度有要求，请主动联系。恢复数据失败客服会主动帮您解决此问题，在此之前建议不要对该云硬盘做其他操作。如果您对客服响应速度有要求，请主动联系。回滚数据失败您可以再次将快照数据回滚到云硬盘。
我可以使用碎片管理做什么？	我可以使用碎片管理做什么？显示碎片管理我可以使用碎片管理做什么？我可以使用碎片管理做什么？采用分块上传的模式上传数据，在下列情况下但不仅限于此通常会导致数据上传失败而产生垃圾数据，因此需要清理这些碎片数据来释放空间。网络条件较差，与OBS的服务器之间的连接经常断开。上传过程中，人为中断上传任务。设备故障。突然断电等特殊情况。
弹性云服务器是否支持Oracle数据库？	支持，但是我们建议您在正式使用前，先做一下性能测试看是否能满足您的需要。
弱点攻击关系图中，弱点与攻击有什么关系？	通过呈现弱点个数趋势变化和被攻击次数趋势变化展现两者之间的关系，帮助用户分析其攻击趋势及可能的原因。被攻击的原因有很多，弱点个数和被攻击次数有一定的关系，但也不是绝对的成正比关系，其他原因也会导致被攻击次数增多，但总体来说，弱点少时被攻击次数也会少，如图1所示。图1弱点攻击关系图点击放大
为什么获取Windows弹性云服务器密码时，系统提示查询不到密码？	问题描述用户登录Windows操作系统的弹性云服务器时，需使用密码方式登录。因此需通过密钥文件，获取该弹性云服务器的初始密码。但是，用户参见获取Windows弹性云服务器的密码内容单击获取密码后，系统提示查询不到密码，导致用户无法登录弹性云服务器。
CloudStream支持哪些数据格式？	支持从DIS上读取编码格式为csv或json格式的数据。只支持从OBS上存放和读取csv格式的数据。
弹性云服务器使用时有什么限制？	建议不要自行升级云服务器的内核版本和操作系统版本；不要卸载云服务器上预装的性能辅助优化软件；不要修改云服务器网卡的MAC地址。
DES如何收费？	数据快递服务DES实现按单计费，按照物理存储介质数量，上传时长分为两个计费项：按物理存储介质数量计费计费因子：物理存储介质个数计费公式：费用物理存储介质个数每个物理存储介质费率单价：530元块磁盘按上传时长计费上传时长是指结束时间起始时间。起始时间点为数据中心管理员挂载磁盘更新完工单的时间点。结束时间点为客户上传完数据后，任务自动终止的时间点。计费因子：时长小时计费公式：费用时长免费时长时长费率单价：36元您还享有3天的免费上传时间，超出免费时间后按天计算，不足一天不收取费用。
Spark集群能访问OBS中的数据吗？	与Hadoop集群一样，Spark集群可以访问存储在OBS系统中的数据，只需在提交作业时将数据输入路径输出路径配置为OBS的路径即可。
“删除”按钮是什么意思？	按钮是什么意思？删除是指删除弹性云服务器，删除时可以选择同时删除弹性IP和数据盘。如果不选择，则会保留，需要您单独删除。
使用DES传输的数据会存放在哪里？	使用DES传输的数据会存放在对象存储服务OBS中，OBS服务是一个基于对象的海量存储服务，为客户提供海量、安全、高可靠、低成本的数据存储能力。关于OBS服务的详细介绍可参见对象存储服务
什么是Anti	流量清洗？流量清洗服务是对IP地址进行DDoS攻击防护的一种网络安全服务。通过对访问IP地址的数据流量进行实时监控，在网络出口对访问流量进行检测，及时发现进行DDoS攻击的异常流量。在不影响正常业务的前提下，根据用户配置的防护策略，清洗掉异常流量。同时为用户生成监控报表，清晰展示网络流量的安全状况。
我购买的Windows云服务器是否可以实时备份数据，如何备份？	可以。需要开启Windowsserverbackup功能。但是我们建议您使用云硬盘备份，提高您数据的备份可靠性。Linux的云服务器也可以使用云硬盘备份服务。
使用私有镜像创建的云服务器，是否可以与生成镜像的云服务器硬件规格不同？	使用私有镜像创建的云服务器，其系统盘大小不能任意指定，必须和镜像的系统盘大小相同。、内存、带宽、数据盘可以根据需要进行修改。
除了文档中支持的镜像格式类型，我可以使用其他镜像格式？	目前仅支持VMDK、VHD、QCOW2和ZVHD格式的镜像注册。不支持格式的镜像、包含任何快照卷或者包含差分卷的镜像文件包。用户可以使用qemu开源工具将对应的镜像转换成支持的格式后，再进行上传。平台下qemu开源工具相关安装和使用可以参考以下地址：
什么是亲和与反亲和？	在应用没有容器化之前，原先一个虚机上会装多个组件，进程间会有通信。但在做容器化拆分的时候，往往直接按进程拆分容器，比如业务进程一个容器，监控日志处理或者本地数据放在另一个容器，并且有独立的生命周期。这时如果他们分布在网络中两个较远的点，请求经过多次转发，性能会很差。亲和性可以实现就近部署，增强网络能力实现通信上的就近路由，减少网络的损耗。反亲和性主要是出于高可靠性考虑，尽量分散实例，某个节点故障的时候，对应用的影响只是N分之一或者只是一个实例。
